transaction_id;request_no;channel;calltype;addresstypecode;addresstypedesc;companyname;addressno;moo;village;floor;roomno;trok;soi;road;subdistrictcode;subdistrictnametha;districtcode;districtnametha;provincecode;provincenametha;zipcode;requestno;fulladdress;input_applicant;idcard;prefix;prefixcode;name;surname;fullname;mobile;hometel;nationality;persontypecode;maritalstatuscode;birthdate;ageyear;agemonth;ageday;militaryservicecode;residenttypecode;officetel;companycode;companycategorycode;responsibility;occupationgroupcode;occupationtypecode;businesstypecode;createdate;createby;updatedate;updateby;accountno;bankid;existingcustomerflag;cardtype;cardexpirydate;firstnameeng;surnameeng;fullnameeng;childnumber;educationcode;sexcode;residencetypecode;rentalchargeamt;housingtypecode;livingplaceperiodyear;livingplaceperiodmonth;creditbankaccounttypecode;creditbankaccountno;creditbankaccountname;creditbankcode;creditbankbranchcode;faxno;emailaddress;occupsubgroupcode;seqno;relationcode;hometelend;hometelextstart;officetelend;officetelextstart;officetelextend;contractno;creditanalysisbranchid;creditanalysisbranchcode;creditanalysisbranchname;guarantor;hpreferencenumber;producttypecode;producttypename;cartypename;refcontractno;oldcartypecode;oldcartypename;campaigncode;campaigndesc;brandid;brandcode;modelid;modelcode;modelnameeng;maillingaddress;digitflag;plusdownflag;calmotoflag;reffinanceamt;financeamt;financevat;financeexvat;termid;term;interest;refflatrate;flatrate;installmentamt;installmentvat;installmentexvat;contractamt;contractvat;contractexvat;vatrate;effrateact;mktareaid;mktuserid;mktcode;mktfullname;mktfirstname;mktstatus;mktcard;mktposition;mktprohibit;mktbranchid;mktbranchcode;mktbranchname;mktteamid;mktteamcode;mktteamnameeng;mktteamleaderid;mktzoneid;mktzonecode;mktteamnameeng;dealerid;dealernametha;dealernameeng;dealerstatus;dealerprohibit;showroomid;showroomcode;showroomnametha;showroomnameeng;dealeroffsetflag;verifyncbflag;ncbconsentno;requestdate;contractdate;applicationstatus;ncb01;ncb02;ncb03;ncb04;ncb05;adddatetime;verifyncbdatetime;pendingdatetime;finishdatetime;supportday;supporttime;creditday;credittime;totalpendingday;totalpendingtime;totalfinishday;totalfinishtime;overridedate;overridepersonuserid;overridepersonname;creditanalystuserid;creditanalystusername;creditanalystname;approvaluserid;approvalname;approvedflag;approveddate;approvedreason;canceldate;cancelreasoncode;cancelreasonname;cancelreasonnote;activeflag;createbyname;creditanalysispassbranchid;creditanalysispassbranchcode;creditanalysispassbranchname;cashout;smsfielddatetime;assignedapprovaluserid;assignedapprovalname;bigbike;interestper;subproducttype;modelgroupcode;conditioncode;caramt;downamt;wholesaleprice;producttype;startcode;startsystem;breakcode;breaksystem;wheelcode;wheelsystem;gearcode;gear;cc;firstduedate;colorcode;colornameeng;paydate;areacode;areanameeng;occupnameeng;occupgrdnameeng;outstandingpercent;usertype;paytype;ageofworkyear;ageofworkmonth;incometotal;sex;slip;description;campaigndescstring;overridepositioncode;overridecriteria;showroomverify;showroomzipcode;highriskcmos;highriskdealers;cardexpireddate;diff;contracttypecode;applydate;subproducttypecode;saleschannelcode;salesregioncode ;saleszonecode;salesbranchcode;loanpurposecode;paymentchannelcode;requestminfinanceamt;requestmaxfinanceamt;requestterm;selectedterm;appbranchcode;appzonecode;appregioncode;installmentnoninncb;appbranchname;applicationstatusname;shortfromflag;capturetype;reactivatetypecode;refoldrequestno;adjustadditionalmonthlydebt;totaldbrafteradjust;totalmonthlydebtafteradjust;hrsegment;retentionsms;ncbscorename;ncbscore;ncbscoregrade;ncbscoredescription;ncbodds;ncbreason1;ncbreason2;ncbreason3;ncbreason4;ncbreason5;utilzationnumrevolvinggt80;utilzationnumccgt80;newaccountnumunsecure;unsecuredexposure;scoringconsent;consentdate;refconditioncode;brokerascustomer;brokerasguarantor;topdealer;skippayment;refskippaymentterm;retentionflag;workpermitexpireddate;diffworkpermit;retailprice;occupsubgrpnameeng;numberofrental;houseandworksameaddress;suspectcode;suspectdesc;tierno;termstart;termend;interest;idcardnumber;decision_date;preassetstatuscode;currassetstatuscode;overdueexvat;vatoverdue;advanceamt;advanceexvat;insuranceasset;remark;accountdate;closestatus;requestnodisplay;idcardno;custname;custsurname;blacklistsource;createbyid;updatebyid;updatebyname;hitdesc;hitidcard;hitcustname;hitcurrentaddress;hitofficeaddress;hitmobiletel;hithometel;hitofficetel;hitworkcompany;persontype;workcompanyname;blacklistrequestno;blacklistrequestdate;officefulladdress;officeaddressno;officemoo;officevillage;officefloor;officeroomno;officetrok;officesoi;officeroad;officesubdistrictcode;officedistrictcode;officeprovincecode;officezipcode;hometelextend;datasource;lastretrievedate;customerstatus;approvedate;approveby;checkruleresult;amlresult;blacklistresult;bankruptcyresult;existhistresult;dupappresult;duprelatedpersonresult;ncbgrade;servicearea;frauddocument;validitydocument;customerverify;incomeverify;complianceresponse;duplicaterequestno;decisioncode;appstatusdate;currentholderuser;hitcreditbankaccountno;hitmobiletel;dupmobiletel;latestdqstatus;currentblockcode;loanamount;outstandingbalance;paymenthistory;noofxday;noof30day;noof60day;closedate;contractnumber;historypayment;latestpaymentdate;latestassetstatuscode;latestassetstatusdate;rejectcode1;rejectreason1;rejectcode2;rejectreason2;rejectcode3;rejectreason3;rejectcode4;rejectreason4;rejectcode5;rejectreason5;close_status;close_date;guarseqno;relationdesc;opinion;incomeperinstallment;houseaddressno;housemoo;housevillage;housefloor;houseroomno;housetrok;housesoi;houseroad;housesubdistrictcode;housesubdistrict;housedistrictcode;housedistrict;houseprovincecode;houseprovince;housezipcode;currentaddressno;currentmoo;currentvillage;currentfloor;currentroomno;currenttrok;currentsoi;currentroad;currentsubdistrictcode;currentsubdistrict;currentdistrictcode;currentdistrict;currentprovincecode;currentprovince;currentzipcode;officecompany;mailingaddressno;maililngmoo;mailingvillage;mailingfloor;mailingroomno;mailingtrok;mailingsoi;mailingroad;mailingsubdistrictcode;mailingsubdistrict;mailingdistrictcode;mailingdistrict;mailingprovincecode;mailingprovince;mailingzipcode;existingguarantorflag;blacklistflag;datamartprofileflag;insuranceflag;guarantortargetarea;guarantorservicearea;hprefname;hprefsurname;hprefrelationcode;hprefrelationname;hpreftel1;hpreftel2;hprefprovincename;hometelno;hometelnodisplay;mobiletelno;mobiletelnodisplay;statustype;applicationstatuscode;creditanalysisreport;contractnodisplay;contractinfo;arcard;insurancedate;claimtype;custfullname;applicanttype;mailingdoctypecode;mailingdoctypedesc;company;addressno;runningsubject;runningaccount;membercode;membershortname;accountnumber;accounttype;ownershipindicator;currencycode;dateaccountopened;dateoflastpayment;dateaccountclosed;asofdate;creditlimitoriginalloanamount;amountowed;amountpastdue;defaultdate;installmentfrequency;installmentamount;installmentnumberofpayment;paymenthistorystartdate;paymenthistoryenddate;loanobjective;dateoflastdebtrestructure;percentpayment;typeofcreditcard;numberofcoborrowers;unitmake;unitmodel;credittype;descacctype;descownership;descaccstatus;desccredittype;descloanclass;paymt;paymtdate;descnumday;idtypecode;descidtype;namecustomer;addresscustomer;accountstatus;collateral1;collateral2;collateral3;enquirydate;runningenq;enquirytime;enquirypurpose;prefixname;businesstypename;income;department;position;companyregiscertno;salaryamt;otherincomeamt;bonustypecode;bonusamtperyear;bonusmonthperyear;bonusamtpermonth;creditturnoveramt;profitmarginpercent;grossincomeamt;verifyincomeamt;currentjoblongevityyear;currentjoblongevitymonth;previousworkplace;previousbusinesstypecode;previousofficetel;previousofficetelend;previousofficetelextstart;previousofficetelextend;previousjoblongevityyear;previousjoblongevitymonth;totaljoblongevityyear;totaljoblongevitymonth;salarypaymentmethod;transferdate;loanterm;installamt;overduestatus;overdueamount;financeamtexvat;priciplebalanceexvat;interestreceivedexvat;assetstatus;auctionprice;auctiondate;selllossamount;selllossrecovery;writeoffamount;baddebtrecovery;insuranceclaimamount;principalbal;closeddate;interestreceivedinvat;payment;outstandingbal;persontypedesc;cardtypedesc;nationalitycode;nationalitydesc;racecode;racedesc;cardissueat;cardissuedate;taxno;militaryservicedesc;residenttypedesc;maritalstatusdesc;nickname;branchcode;branchnameeng;banknameeng;bankbranchnameeng;decision;decisiondate;occupationcode;salary;incomeamt;telephonetypecode;telephonetypedesc;telephoneseqno;telephonenumberstart;telephonenumberend;telephoneextstart;telephoneextend;note;placeofbirth;fosternumber;verifymobiletelwith;verifyhometelwith;verifyofficetelwith;modifyaddresscode;modifyaddressreason;documentverifycode;holidaytypecode;outstandingother;outstandingotherinstallment;creditpolicy;withoutcriteriaflag;overrideflag;creditanalystagreeflag;creditanalystagreereason;mapprofileflag;redzoneprofileflag;decreasefinanceflag;decreasefinanceamt;advanceinstallmentflag;advanceinstallmentterm;beginingflag;addguarantorflag;usercartypecode;usercarrelationcode;usercarrelationdesc;usercarreason;usercarname;usercarphone;usercarphoneext;usercaraddress;userpaytypecode;userpayrelationcode;userpayrelationdesc;userpayreason;userpayname;userpayphone;userpayphoneext;userpayaddress;decisionresultname;decisionresultcolorred;decisionresultcolorgreen;decisionresultcolorblue;originalinterestrate;pdscore;pdscorerank;fixedincome;currectsubdistrictcode;mailingmoo;validdocverify;completedocverify;customerexistingverify;employmentverify;workpermit;hptargetarea;beginingterm;reliablebillflag;applicatioincome;calculationincome;standard;cauadjustincome;telephoneno;contactdate;actioncode;actiondescription;deptcode;deptnameen;deptnameth;resultcode;membershipdatefrom;membershipdateto;cartypecode;brandname;fullflatrate;dealercode;businesstype;tel;telend;telextstart;telextend;mob;requestnumber;officesubdistrict;officedistrict;officeprovince;reason;otherincome;grossincome;ncbflag;bankcode;bankbranchcode;mktzonenameeng;salesregioncode
20290927150000;0123065712;MTR;02;0000;1010;LCG;999;1;2;1;11;2;2;777;0807;A;5754;หนองดินแดง;00099;นครปฐม;0000;124154236;xxxx;xx;1.7399E+12;นาย;001;เอกพล;ศรีพรหม;นาย เอกพล ศรีพรหม;0630600091;-;TH;P;06;2005-05-10T00:00:00;19;4;19;00;01;034286292;034286292;11;ส่งสินค้า;010;124;02;2024-09-29T10:56:18.013;10114;2024-10-03T13:32:02.427;1;0000;3;A;RE;0912;Aek;Sri;Aek Sri;-;032;M;000;xxx;03211;2034;32;0000;00;SC;SC01;SSC;xxxx;-;0000;xxxx;3;00;01;00;01;09;0504600139241;1;001;สำนักงานใหญ่;1;2;05;Motorcycle;New Car;0;Y;New Car;2471040024;0;3;71;1191;711926;PCX 106;2;0;0;0;112100.0000;94600.0000;6188.7900;88411.2100;6;42;1.1000;13.5600;13.2000;3292.0000;215.3600;3076.6400;138264.0000;9045.3100;129218.6900;7.0000;22.8475;4;12577;3191;อาจณรงค์ แก้วกรูด;อาจณรงค์;1;-;Sales Exec;-;28;027;ศูนย์อำนวยสินเชื่อนครปฐม;277;1109;1109 NAKHONPATHOM;9971;13;11;WEST;402;บจก. เกรียงไกร มอเตอร์เซลส์;KRIANGKRAIMOTORSALE CO., LTD.;Active;-;239;7007401;สนญ. เมืองสุพรรณบุรี;HO. MUANGSUPHANBURI;0;1;0124154236;2024-09-29T10:53:01.227;2023-12-07T00:00:00;2;1;2;3;4;5;2024-09-29T10:53:01.410;2024-09-29T10:56:55.190;2024-09-29T11:10:23.270;0;0;3;0;14;0;17;0;0;0;0;0;9992;chanidapha.k;ชณิดาภา แคล้วเครือ;0;0;0;2023-12-03T14:10:44.383;0;0;0;0;0;1;pada.l;1;001;สำนักงานใหญ่;17500.0000;0;452;yingyos.h;0;0;Normal;03;801;0.0;0.0;87312.0000;05;02;Electric Starter;01;Disc-Disc;02;Mag wheel;01;Automatic;160;2024-01-05T00:00:00;0;0;0;04;Central Area 1,2;0;Salary;27.4300;0;A;1;3;12000.0000;M;A;1.1000;0;011;A;Y;72000;0;2;2031-05-09T00:00:00;79;111;09;001;012;99;100;01;001;1;0;1;A;S;111;222;333;T;ABC;O;1;P;000;01;111;A;100;0;0;AAA;10;A;Y;0;1;2;3;4;5;A;Z;1;00;1;2024-10-02T11:53:59.423;00;0;0;0;0;A;0;01;100;93900.0000;Registered company - Permanent Staff;0;N;0;10;0;00;A;1.1000;1739902182412;2023-12-07T00:00:00;0;0;0.0000;0.0000;0.0000;0.0000;A;COS040 GenerateContract;2024-10-03T13:32:02.427;A;00;001;Dan;Wen;0;000;100;A;10;001;AAA;MT;A;00;100;200;TT;F;พนัส;121;12-1;Company;123;5;OT;3;01;00;1;TR;07247;0807;55;73000;1234;000;1;S;00;10;A;B;0;100;000;TR;MR;100;AA;200;Y;Y;Y;T;3422;0099;12/1;0;0001;xxx;000;YY;0999;0000;1;1001;N;000;010;30;0504600139241;001;30;0001;10000;0;1;2;00;001;0002;100;200;300;400;N;12/1;1;0;None;3.6452;116;5;0;1;112;00;000;123;07247;หนองดินแดง;0807;เมืองนครปฐม;58;นครปฐม;73000;0;5;00;1;1;2;13;12;07247;หนองดินแดง;0807;เมืองนครปฐม;58;นครปฐม;73000;Comp;11;5;0;1;00;000;1;20;0807;หนองดินแดง;0787;เมืองนครปฐม;58;นครปฐม;73000;000;N;1;N;Y;Y;จันทร์จิรา;ตั้งต้น;2;แม่;0933018868;0985674536;นนทบุรี;00;000;0000;xxx;Y;P;AA;00;Y;N;12/1;Y;สมใจ;M;0000;00;Comp;12;T;R;100;01;00;P;Y;010;112;00;00;100;123;10000;9999;120213;S;9999;Y;AA;23142;RR;TT;100;RE;0000;YY;992;EE;00;01;100;1000;110;Y;21321;34;0099;0088;Dan;ชลบุรี;002;A;AA;AAA;1203;RE;111;000;MISS;QE;500000;AA;LD;0000;100000;-;0099;2000;5000;6000;Y;100;1000;P;AA;AB;AC;1111;-;-;09321;3219;1122;33;A;O;TR;0321;00;00;AG;10000;7;00;000;F;010;0193;000;022;9999;T;9999;0000;0922;00;1111;Y;00;RE;0000;0;9999;99;A;0212;0011;00;000;99;Dan;000;TU;SC;SSC;AG;0110;001;10000;90000;xxxx;00;01;0;1;0321;0643;-;1103;0000;T;C;C;0099;P;P;000;Y;N;RG;Y;Y;Y;N;Y;N;N;Y;Y;Y;N;Y;xxxx;0001;01010;456;Dan;xxx;-;AA;992;1234;0000;00;CF;xxx;-;AA;Y;N;Y;Y;Y;RE;1;10000;0000;10;Y;Y;N;Y;10;00;100;20;P;xxxx;10000;-;xxxx;0123;-;-;0000;1;เอก;900;-;xxxx;xxxx;xxxx;xxxx;xxxx;xxxx;xxxx;xxxx;xxxx;xxxx;xxxx;xxxx;xxxx;xxxx;;;;;;;;;
20241024_131737;0124058860;MTR;03;0001;1011;AAM;1000;2;3;2;11;3;3;778;0808;A;5755;หนองดินแดง;00100;นครปฐม;0001;124154237;xxxx;xx;1.7399E+12;นางสาว;002;นงนภัส;แก้วไก่;นางสาว นงนภัส แก้วไก่;0630600092;-;TH;P;07;2005-05-10T00:00:01;20;5;19;01;02;034286293;034286293;12;ส่งสินค้า;011;125;03;2024-09-29T10:56:18.014;10115;2024-10-03T13:32:02.428;2;0001;4;A;FE;0913;Aek;Sri;Aek Sri;-;033;F;001;xxx;03212;2035;33;0001;01;SC;SC02;SSC;xxxx;-;0001;xxxx;4;01;02;01;02;10;0504600139243;3;003;สำนักงานใหญ่;3;4;07;Motorcycle;New Car;2;Y;New Car;2471040026;2;5;73;1193;711928;PCX 108;4;2;2;2;112100.0002;94600.0002;6188.7902;88411.2102;8;44;1.1002;13.5602;13.2002;3292.0001;215.3602;3076.6402;138264.0002;9045.3102;129218.6902;7.0002;22.8477;6;12579;3193;อาจณรงค์ แก้วกรูด;อาจณรงค์;3;-;Sales Exec;-;30;029;ศูนย์อำนวยสินเชื่อนครปฐม;279;1111;1111 NAKHONPATHOM;9973;15;13;WEST;404;บจก. เกรียงไกร มอเตอร์เซลส์;KRIANGKRAIMOTORSALE CO., LTD.;Active;-;241;7007403;สนญ. เมืองสุพรรณบุรี;HO. MUANGSUPHANBURI;2;3;0124154238;2024-09-29T10:53:01.229;2023-12-07T00:00:02;4;1;2;3;4;5;2024-09-29T10:53:01.412;2024-09-29T10:56:55.192;2024-09-29T11:10:23.272;2;2;5;2;16;2;19;2;2;2;2;2;9994;chanidapha.k;ชณิดาภา แคล้วเครือ;2;2;2;2023-12-03T14:10:44.385;2;2;2;2;2;3;pada.l;3;003;สำนักงานใหญ่;17500.0002;2;454;yingyos.h;2;2;Normal;05;803;0.2;0.2;87312.0002;07;04;Electric Starter;03;Disc-Disc;04;Mag wheel;03;Automatic;162;2024-01-05T00:00:02;2;2;2;06;Central Area 1,4;2;Salary;27.4302;2;A;3;5;12000.0002;F;A;1.1002;2;013;A;Y;72002;2;4;2031-05-09T00:00:02;81;113;11;003;014;101;102;03;003;3;2;3;A;S;113;224;335;T;ABC;O;3;P;002;03;113;A;102;2;2;AAA;12;A;Y;2;3;0;5;6;7;B;Z;3;02;3;2024-10-02T11:53:59.425;02;0;0;0;0;A;0;03;300;93900.0001;Registered company - Permanent Staff;2;T;2;30;2;02;A;1.1001;1739902182414;2023-12-07T00:00:02;0;0;0.0000;0.0000;0.0000;0.0000;A;COS040 GenerateContract;2024-10-03T13:32:02.429;A;02;003;Dan;Wen;2;002;102;C;30;003;CCC;MT;A;02;102;202;TT;F;พนัส;123;12-3;Company;125;5;OT;5;03;02;3;TR;07247;0809;55;73002;1236;002;3;S;02;30;A;B;2;300;002;TR;MR;300;CC;202;Y;Y;Y;T;3424;0099;12/3;2;0003;xxx;002;NN;1001;0002;3;1003;N;002;012;32;0504600139243;003;32;0003;10002;2;3;4;02;003;0004;102;202;302;402;N;12/3;3;2;None;3.6454;118;7;2;3;114;02;002;125;07249;หนองดินแดง;0809;เมืองนครปฐม;60;นครปฐม;73002;2;7;02;3;3;4;15;14;07249;หนองดินแดง;0809;เมืองนครปฐม;60;นครปฐม;73002;Comp;13;7;2;3;02;002;3;22;0809;หนองดินแดง;0789;เมืองนครปฐม;60;นครปฐม;73002;002;N;3;N;Y;Y;จันทร์จิรา;ตั้งต้น;4;แม่;0933018870;0985674538;นนทบุรี;02;002;0002;xxx;Y;F;AA;02;Y;N;12/3;Y;สมปอง;M;0002;02;Comp;14;T;R;102;03;02;P;Y;012;114;02;02;102;125;10002;10001;120213;S;10001;Y;AA;23144;RR;TT;51;RF;0001;YY;994;BE;02;03;102;1002;112;Y;21323;36;0101;0090;Dan;ชลบุรี;004;A;AA;AAA;1205;RE;113;002;MISS;QE;100001;AA;LD;0002;100002;-;0101;2002;5002;6002;Y;101;1002;F;AA;AB;AC;1113;-;-;09323;3221;1124;35;A;O;TR;0323;02;22;AG;10002;9;02;002;F;012;0195;002;024;10001;T;10001;0002;0924;02;1113;Y;02;RE;0000;2;10001;101;A;0214;0013;02;002;101;Dan;001;TU;SC;SSC;NG;0111;002;10001;90001;xxxx;01;02;1;2;0322;0644;-;1104;0001;C;T;C;0100;F;F;000;N;Y;RG;N;Y;Y;N;Y;N;N;Y;Y;Y;N;Y;xxxx;0002;01011;457;Dan;xxx;-;AA;993;1235;0001;01;CF;xxx;-;AA;Y;N;Y;Y;Y;RE;2;10001;0001;11;Y;Y;N;Y;11;01;101;30;P;xxxx;10001;-;xxxx;0124;-;-;0001;2;เอก;901;-;xxxx;xxxx;xxxx;xxxx;xxxx;xxxx;xxxx;xxxx;xxxx;xxxx;xxxx;xxxx;xxxx;xxxx;;;;;;;;;
716714577;0123065712;MTR;04;0002;1012;LCG;999;1;4;3;11;4;4;779;0809;A;5756;หนองดินแดง;00101;นครปฐม;0002;124154238;xxxx;xx;1.7399E+12;นาง;003;ศศิธร;จำปา;นางศศิธร จำปา;0630600093;-;TH;P;08;2005-05-10T00:00:02;21;6;19;02;03;034286294;034286294;13;ส่งสินค้า;012;126;04;2024-09-29T10:56:18.015;10116;2024-10-03T13:32:02.429;3;0002;5;A;RE;0914;Aek;Sri;Aek Sri;-;034;F;002;xxx;03213;2036;34;0002;02;SC;SC03;SSC;xxxx;-;0002;xxxx;5;02;03;02;03;11;0504600139244;4;004;สำนักงานใหญ่;4;5;08;Car;New Car;3;Y;New Car;2471040027;3;6;74;1194;711929;PCX 109;5;3;3;3;112100.0003;94600.0003;6188.7903;88411.2103;9;45;1.1003;13.5603;13.2003;3292.0002;215.3603;3076.6403;138264.0003;9045.3103;129218.6903;7.0003;22.8478;7;12580;3194;อาจณรงค์ แก้วกรูด;อาจณรงค์;4;-;Sales Exec;-;31;030;ศูนย์อำนวยสินเชื่อนครปฐม;280;1112;1112 NAKHONPATHOM;9974;16;14;WEST;405;บจก. เกรียงไกร มอเตอร์เซลส์;KRIANGKRAIMOTORSALE CO., LTD.;Active;-;242;7007404;สนญ. เมืองสุพรรณบุรี;HO. MUANGSUPHANBURI;3;4;0124154239;2024-09-29T10:53:01.230;2023-12-07T00:00:03;5;1;2;3;4;5;2024-09-29T10:53:01.413;2024-09-29T10:56:55.193;2024-09-29T11:10:23.273;3;3;6;3;17;3;20;3;3;3;3;3;9995;chanidapha.k;ชณิดาภา แคล้วเครือ;3;3;3;2023-12-03T14:10:44.386;3;3;3;3;3;4;pada.l;4;004;สำนักงานใหญ่;17500.0003;3;455;yingyos.h;3;3;Normal;06;804;0.3;0.3;87312.0003;08;05;Electric Starter;04;Disc-Disc;05;Mag wheel;04;Automatic;163;2024-01-05T00:00:03;3;3;3;07;Central Area 1,5;3;Salary;27.4303;3;A;4;6;12000.0003;M;A;1.1003;3;014;A;Y;72003;3;5;2031-05-09T00:00:03;82;114;12;004;015;102;103;04;004;4;3;4;A;S;114;225;336;T;ABC;O;4;P;003;04;114;A;103;3;3;AAA;13;B;Y;3;4;1;6;7;8;B;Y;4;03;4;2024-10-02T11:53:59.426;03;0;0;0;0;A;0;04;400;93910.0001;Registered company - Permanent Staff;3;N;3;40;3;03;B;2.1001;1739902182415;2023-12-07T00:00:03;0;0;0.0000;0.0000;0.0000;0.0000;A;COS040 GenerateContract;2024-10-03T13:32:02.430;A;03;004;Dan2;Wen;3;003;103;A;40;004;AAA;FT;A;03;103;203;FF;M;พนัส;124;12-4;Company;126;5;OT;6;04;03;4;TR;07247;0810;55;73003;1237;003;4;T;03;40;Z;B;3;400;003;TR;MR;400;AA;203;N;N;Y;M;3425;0099;12/4;3;0004;xxx;003;NN;1002;0003;4;1004;Y;003;013;33;0504600139244;004;33;0004;10003;3;4;5;03;004;0005;103;203;303;403;N;12/4;4;3;None;3.6455;119;8;3;4;115;03;003;126;07250;หนองดินแดง;0810;เมืองนครปฐม;61;นครปฐม;73003;3;8;03;4;4;5;16;15;07250;หนองดินแดง;0810;เมืองนครปฐม;61;นครปฐม;73003;Comp;14;8;3;4;03;003;4;23;0810;หนองดินแดง;0790;เมืองนครปฐม;61;นครปฐม;73003;003;N;4;N;Y;Y;จันทร์จิรา;ตั้งต้น;5;พ่อ;0933018871;0985674539;นนทบุรี;03;003;0003;xxx;T;P;AA;03;N;Y;12/4;Y;สมใจ;M;0003;03;Comp;15;T;R;103;04;03;P;Y;013;115;03;03;103;126;10003;10002;120213;S;10002;Y;AA;23145;RR;TT;52;RF;0002;YY;995;BE;03;04;103;1003;113;Y;21324;37;0102;0091;Dan;ชลบุรี;005;A;AA;AAA;1206;RE;114;003;MISTER;RC;100002;BB;EM;0003;100003;-;0102;2003;5003;6003;N;102;1003;F;AA;AB;AC;1114;-;-;09324;3222;1125;36;A;O;QR;0324;03;33;AG;10003;10;03;003;F;013;0196;003;025;10002;Y;10002;0003;0925;03;1114;Y;03;FE;0000;3;10002;102;A;0215;0014;03;003;102;Dan;002;TU;SC;SSC;NG;0112;003;10002;90002;xxxx;02;03;2;3;0323;0645;-;1105;0002;T;C;C;0101;P;P;000;Y;N;RG;Y;Y;Y;N;Y;N;N;Y;Y;Y;N;Y;xxxx;0003;01012;458;Dan;xxx;-;AA;994;1236;0002;02;CF;xxx;-;AA;Y;N;Y;Y;Y;RE;3;10002;0002;12;Y;Y;N;Y;12;02;102;40;P;xxxx;10002;-;xxxx;0125;-;-;0002;3;เอก;902;-;xxxx;xxxx;xxxx;xxxx;xxxx;xxxx;xxxx;xxxx;xxxx;xxxx;xxxx;xxxx;xxxx;xxxx;;;;;;;;;
906383135;0124058860;MTR;05;0003;1010;AAM;1000;2;5;4;11;5;5;780;0810;A;5757;หนองดินแดง;00102;นครปฐม;0003;124154239;xxxx;xx;1.7399E+12;นาย;004;เอกพล;ศรีพรหม;นาย เอกพล ศรีพรหม;0630600094;-;TH;P;09;2005-05-10T00:00:03;22;7;19;03;04;034286295;034286295;14;ส่งสินค้า;013;127;05;2024-09-29T10:56:18.016;10117;2024-10-03T13:32:02.430;4;0003;6;A;FE;0915;Aek;Sri;Aek Sri;-;035;M;003;xxx;03214;2037;35;0003;03;SC;SC04;SSC;xxxx;-;0003;xxxx;6;03;04;03;04;12;0504600139245;5;005;สำนักงานใหญ่;5;6;09;Motorcycle;New Car;4;Y;New Car;2471040028;4;7;75;1195;711930;PCX 110;6;4;4;4;112100.0004;94600.0004;6188.7904;88411.2104;10;46;1.1004;13.5604;13.2004;3292.0003;215.3604;3076.6404;138264.0004;9045.3104;129218.6904;7.0004;22.8479;8;12581;3195;อาจณรงค์ แก้วกรูด;อาจณรงค์;5;-;Sales Exec;-;32;031;ศูนย์อำนวยสินเชื่อนครปฐม;281;1113;1113 NAKHONPATHOM;9975;17;15;WEST;406;บจก. เกรียงไกร มอเตอร์เซลส์;KRIANGKRAIMOTORSALE CO., LTD.;Active;-;243;7007405;สนญ. เมืองสุพรรณบุรี;HO. MUANGSUPHANBURI;4;5;0124154240;2024-09-29T10:53:01.231;2023-12-07T00:00:04;6;1;2;3;4;5;2024-09-29T10:53:01.414;2024-09-29T10:56:55.194;2024-09-29T11:10:23.274;4;4;7;4;18;4;21;4;4;4;4;4;9996;chanidapha.k;ชณิดาภา แคล้วเครือ;4;4;4;2023-12-03T14:10:44.387;4;4;4;4;4;5;pada.l;5;005;สำนักงานใหญ่;17500.0004;4;456;yingyos.h;4;4;Normal;07;805;0.4;0.4;87312.0004;09;06;Electric Starter;05;Disc-Disc;06;Mag wheel;05;Automatic;164;2024-01-05T00:00:04;4;4;4;08;Central Area 1,6;4;Salary;27.4304;4;A;5;7;12000.0004;F;A;1.1004;4;015;A;Y;72004;4;6;2031-05-09T00:00:04;83;115;13;005;016;103;104;05;005;5;4;5;A;S;115;226;337;T;ABC;O;5;P;004;05;115;A;104;4;4;AAA;14;A;Y;4;5;2;7;8;9;A;Z;5;04;5;2024-10-02T11:53:59.427;04;0;0;0;0;A;0;05;500;93900.0002;Registered company - Permanent Staff;4;M;4;50;4;04;A;1.1002;1739902182416;2023-12-07T00:00:04;0;0;0.0000;0.0000;0.0000;0.0000;A;COS040 GenerateContract;2024-10-03T13:32:02.431;A;04;005;Dan;Wen;4;004;104;B;50;005;BBB;MT;A;04;104;204;TT;F;พนัส;125;12-5;Company;127;5;OT;7;05;04;5;TR;07247;0811;55;73004;1238;004;5;S;04;50;A;B;4;500;004;TR;MR;500;BB;204;N;Y;N;T;3426;0099;12/5;4;0005;xxx;004;YY;1003;0004;5;1005;N;004;014;34;0504600139245;005;34;0005;10004;4;5;6;04;005;0006;104;204;304;404;N;12/5;5;4;None;3.6456;120;9;4;5;116;04;004;127;07251;หนองดินแดง;0811;เมืองนครปฐม;62;นครปฐม;73004;4;9;04;5;5;6;17;16;07251;หนองดินแดง;0811;เมืองนครปฐม;62;นครปฐม;73004;Comp;15;9;4;5;04;004;5;24;0811;หนองดินแดง;0791;เมืองนครปฐม;62;นครปฐม;73004;004;N;5;N;Y;Y;จันทร์จิรา;ตั้งต้น;6;แม่;0933018872;0985674540;นนทบุรี;04;004;0004;xxx;Y;P;AA;04;Y;N;12/5;Y;สมชาย;M;0004;04;Comp;16;T;R;104;05;04;P;Y;014;116;04;04;104;127;10004;10003;120213;S;10003;Y;AA;23146;RR;TT;53;RF;0003;YY;996;BE;04;05;104;1004;114;Y;21325;38;0103;0092;Dan;ชลบุรี;006;A;AA;AAA;1207;RE;115;004;MISS;QE;100003;AA;LD;0004;100004;-;0103;2004;5004;6004;Y;103;1004;F;AA;AB;AC;1115;-;-;09325;3223;1126;37;A;O;TR;0325;04;44;AG;10004;11;04;004;F;014;0197;004;026;10003;T;10003;0004;0926;04;1115;Y;04;RE;0000;4;10003;103;A;0216;0015;04;004;103;Dan;003;TU;SC;SSC;NG;0113;004;10003;90003;xxxx;03;04;3;4;0324;0646;-;1106;0003;C;T;C;0102;F;F;000;N;Y;RG;N;Y;Y;N;Y;N;N;Y;Y;Y;N;Y;xxxx;0004;01013;459;Dan;xxx;-;AA;995;1237;0003;03;CF;xxx;-;AA;Y;N;Y;Y;Y;RE;4;10003;0003;13;Y;Y;N;Y;13;03;103;50;P;xxxx;10003;-;xxxx;0126;-;-;0003;4;เอก;903;-;xxxx;xxxx;xxxx;xxxx;xxxx;xxxx;xxxx;xxxx;xxxx;xxxx;xxxx;xxxx;xxxx;xxxx;;;;;;;;;
426393326;0124058860;MTR;06;0004;1011;LCG;999;1;2;5;11;6;6;781;0811;A;5758;หนองดินแดง;00103;นครปฐม;0004;124154240;xxxx;xx;1.7399E+12;นางสาว;005;นงนภัส;แก้วไก่;นางสาว นงนภัส แก้วไก่;0630600095;-;TH;P;10;2005-05-10T00:00:04;23;8;19;04;05;034286296;034286296;15;ส่งสินค้า;014;128;06;2024-09-29T10:56:18.017;10118;2024-10-03T13:32:02.431;5;0004;7;A;RE;0916;Aek;Sri;Aek Sri;-;036;F;004;xxx;03215;2038;36;0004;04;SC;SC05;SSC;xxxx;-;0004;xxxx;7;04;05;04;05;13;0504600139246;6;006;สำนักงานใหญ่;6;7;10;Motorcycle;New Car;5;Y;New Car;2471040029;5;8;76;1196;711931;PCX 111;7;5;5;5;112100.0005;94600.0005;6188.7905;88411.2105;11;47;1.1005;13.5605;13.2005;3292.0004;215.3605;3076.6405;138264.0005;9045.3105;129218.6905;7.0005;22.8480;9;12582;3196;อาจณรงค์ แก้วกรูด;อาจณรงค์;6;-;Sales Exec;-;33;032;ศูนย์อำนวยสินเชื่อนครปฐม;282;1114;1114 NAKHONPATHOM;9976;18;16;WEST;407;บจก. เกรียงไกร มอเตอร์เซลส์;KRIANGKRAIMOTORSALE CO., LTD.;Active;-;244;7007406;สนญ. เมืองสุพรรณบุรี;HO. MUANGSUPHANBURI;5;6;0124154241;2024-09-29T10:53:01.232;2023-12-07T00:00:05;7;1;2;3;4;5;2024-09-29T10:53:01.415;2024-09-29T10:56:55.195;2024-09-29T11:10:23.275;5;5;8;5;19;5;22;5;5;5;5;5;9997;chanidapha.k;ชณิดาภา แคล้วเครือ;5;5;5;2023-12-03T14:10:44.388;5;5;5;5;5;6;pada.l;6;006;สำนักงานใหญ่;17500.0005;5;457;yingyos.h;5;5;Normal;08;806;0.5;0.5;87312.0005;10;07;Electric Starter;06;Disc-Disc;07;Mag wheel;06;Automatic;165;2024-01-05T00:00:05;5;5;5;09;Central Area 1,7;5;Salary;27.4305;5;A;6;8;12000.0005;M;A;1.1005;5;016;A;Y;72005;5;7;2031-05-09T00:00:05;84;116;14;006;017;104;105;06;006;6;5;6;A;S;116;227;338;T;ABC;O;6;P;005;06;116;A;105;5;5;AAA;15;B;Y;5;6;3;8;9;10;C;Y;6;05;6;2024-10-02T11:53:59.428;05;0;0;0;0;A;0;06;600;93910.0002;Registered company - Permanent Staff;5;T;5;60;5;05;B;2.1002;1739902182417;2023-12-07T00:00:05;0;0;0.0000;0.0000;0.0000;0.0000;A;COS040 GenerateContract;2024-10-03T13:32:02.432;A;05;006;Dan3;Wen;5;005;105;C;60;006;CCC;FT;A;05;105;205;FF;M;พนัส;126;12-6;Company;128;5;OT;8;06;05;6;TR;07247;0812;55;73005;1239;005;6;T;05;60;Z;B;5;600;005;TR;MR;600;CC;205;N;N;N;M;3427;0099;12/6;5;0006;xxx;005;YY;1004;0005;6;1006;Y;005;015;35;0504600139246;006;35;0006;10005;5;6;7;05;006;0007;105;205;305;405;N;12/6;6;5;None;3.6457;121;10;5;6;117;05;005;128;07252;หนองดินแดง;0812;เมืองนครปฐม;63;นครปฐม;73005;5;10;05;6;6;7;18;17;07252;หนองดินแดง;0812;เมืองนครปฐม;63;นครปฐม;73005;Comp;16;10;5;6;05;005;6;25;0812;หนองดินแดง;0792;เมืองนครปฐม;63;นครปฐม;73005;005;N;6;N;Y;Y;จันทร์จิรา;ตั้งต้น;7;พ่อ;0933018873;0985674541;นนทบุรี;05;005;0005;xxx;T;F;AA;05;N;Y;12/6;Y;สมปอง;M;0005;05;Comp;17;T;R;105;06;05;P;Y;015;117;05;05;105;128;10005;10004;120213;S;10004;Y;AA;23147;RR;TT;54;RF;0000;YY;997;BE;05;06;105;1005;115;Y;21326;39;0104;0093;Dan;ชลบุรี;007;A;AA;AAA;1208;RE;116;005;MISTER;RC;100004;BB;EM;0005;100005;-;0104;2005;5005;6005;N;104;1005;F;AA;AB;AC;1116;-;-;09326;3224;1127;38;A;O;QR;0326;05;55;AG;10005;12;05;005;F;015;0198;005;027;10004;Y;10004;0005;0927;05;1116;Y;05;FE;0000;5;10004;104;A;0217;0016;05;005;104;Dan;004;TU;SC;SSC;NG;0114;005;10004;90004;xxxx;04;05;4;5;0325;0647;-;1107;0004;T;C;C;0103;P;P;000;Y;N;RG;Y;Y;Y;N;Y;N;N;Y;Y;Y;N;Y;xxxx;0005;01014;460;Dan;xxx;-;AA;996;1238;0004;04;CF;xxx;-;AA;Y;N;Y;Y;Y;RE;5;10004;0004;14;Y;Y;N;Y;14;04;104;60;P;xxxx;10004;-;xxxx;0127;-;-;0004;5;เอก;904;-;xxxx;xxxx;xxxx;xxxx;xxxx;xxxx;xxxx;xxxx;xxxx;xxxx;xxxx;xxxx;xxxx;xxxx;;;;;;;;;
20290927150001;0123065712;MTR;07;0000;1012;AAM;1000;2;3;1;11;2;7;782;0812;A;5759;หนองดินแดง;00104;นครปฐม;0005;124154241;xxxx;xx;1.7399E+12;นาง;006;ศศิธร;จำปา;นางศศิธร จำปา;0630600096;-;TH;P;11;2005-05-10T00:00:05;24;9;19;05;06;034286297;034286297;16;ส่งสินค้า;015;129;07;2024-09-29T10:56:18.018;10119;2024-10-03T13:32:02.432;6;0005;8;A;FE;0917;Aek;Sri;Aek Sri;-;037;F;005;xxx;03216;2039;37;0005;05;SC;SC06;SSC;xxxx;-;0005;xxxx;8;05;06;05;06;14;0504600139247;7;007;สำนักงานใหญ่;7;8;11;Motorcycle;New Car;6;Y;New Car;2471040030;6;9;77;1197;711932;PCX 112;8;6;6;6;112100.0006;94600.0006;6188.7906;88411.2106;12;48;1.1006;13.5606;13.2006;3292.0005;215.3606;3076.6406;138264.0006;9045.3106;129218.6906;7.0006;22.8481;10;12583;3197;อาจณรงค์ แก้วกรูด;อาจณรงค์;7;-;Sales Exec;-;34;033;ศูนย์อำนวยสินเชื่อนครปฐม;283;1115;1115 NAKHONPATHOM;9977;19;17;WEST;408;บจก. เกรียงไกร มอเตอร์เซลส์;KRIANGKRAIMOTORSALE CO., LTD.;Active;-;245;7007407;สนญ. เมืองสุพรรณบุรี;HO. MUANGSUPHANBURI;6;7;0124154242;2024-09-29T10:53:01.233;2023-12-07T00:00:06;8;1;2;3;4;5;2024-09-29T10:53:01.416;2024-09-29T10:56:55.196;2024-09-29T11:10:23.276;6;6;9;6;20;6;23;6;6;6;6;6;9998;chanidapha.k;ชณิดาภา แคล้วเครือ;6;6;6;2023-12-03T14:10:44.389;6;6;6;6;6;7;pada.l;7;007;สำนักงานใหญ่;17500.0006;6;458;yingyos.h;6;6;Normal;09;807;0.6;0.6;87312.0006;11;08;Electric Starter;07;Disc-Disc;08;Mag wheel;07;Automatic;166;2024-01-05T00:00:06;6;6;6;10;Central Area 1,8;6;Salary;27.4306;6;A;7;9;12000.0006;M;A;1.1006;6;017;A;Y;72006;6;8;2031-05-09T00:00:06;85;117;15;007;018;105;106;07;007;7;6;7;A;S;117;228;339;T;ABC;O;7;P;006;07;117;A;106;6;6;AAA;16;A;Y;6;7;4;9;10;11;C;Y;7;06;7;2024-10-02T11:53:59.429;06;0;0;0;0;A;0;07;700;93910.0003;Registered company - Permanent Staff;6;N;6;70;6;06;A;2.1003;1739902182418;2023-12-07T00:00:06;0;0;0.0000;0.0000;0.0000;0.0001;A;COS040 GenerateContract;2024-10-03T13:32:02.433;A;06;007;Dan;Wen;6;006;106;A;70;007;AAA;MT;A;06;106;206;TT;F;พนัส;127;12-7;Company;129;6;OT;9;07;06;7;TR;07247;0813;55;73006;1240;006;7;S;06;70;A;B;6;700;006;TR;MR;700;CC;206;Y;N;Y;T;3428;0099;12/7;6;0007;xxx;006;YY;1005;0006;7;1007;N;006;016;36;0504600139247;007;36;0007;10006;6;7;8;06;007;0008;106;206;306;406;N;12/7;7;6;None;3.6458;122;11;6;7;118;06;006;129;07253;หนองดินแดง;0813;เมืองนครปฐม;64;นครปฐม;73006;6;11;06;7;7;8;19;18;07253;หนองดินแดง;0813;เมืองนครปฐม;64;นครปฐม;73006;Comp;17;11;6;7;06;006;7;26;0813;หนองดินแดง;0793;เมืองนครปฐม;64;นครปฐม;73006;006;N;7;N;Y;Y;จันทร์จิรา;ตั้งต้น;8;แม่;0933018874;0985674542;นนทบุรี;06;006;0006;xxx;Y;F;AA;06;Y;N;12/7;Y;สมใจ;M;0006;06;Comp;18;T;R;106;07;06;P;Y;016;118;06;06;106;129;10006;10005;120213;S;10005;Y;AA;23148;RR;TT;55;RF;0001;YY;998;BE;06;07;106;1006;116;Y;21327;40;0105;0094;Dan;ชลบุรี;008;A;AA;AAA;1209;RE;117;006;MISS;QE;100005;AA;LD;0006;100006;-;0105;2006;5006;6006;Y;105;1006;F;AA;AB;AC;1117;-;-;09327;3225;1128;39;A;O;TR;0327;06;66;AG;10006;13;06;006;F;016;0199;006;028;10005;T;10005;0006;0928;06;1117;Y;06;RE;0000;6;10005;105;A;0218;0017;06;006;105;Dan;005;TU;SC;SSC;NG;0115;006;10005;90005;xxxx;05;06;5;6;0326;0648;-;1108;0005;C;T;C;0104;F;F;000;N;Y;RG;N;Y;Y;N;Y;N;N;Y;Y;Y;N;Y;xxxx;0006;01015;461;Dan;xxx;-;AA;997;1239;0005;05;CF;xxx;-;AA;Y;N;Y;Y;Y;RE;6;10005;0005;15;Y;Y;N;Y;15;05;105;70;P;xxxx;10005;-;xxxx;0128;-;-;0005;6;เอก;905;-;xxxx;xxxx;xxxx;xxxx;xxxx;xxxx;xxxx;xxxx;xxxx;xxxx;xxxx;xxxx;xxxx;xxxx;;;;;;;;;
20241024_131738;0124058860;MTR;08;0001;1010;LCG;999;1;4;2;11;3;8;783;0813;A;5760;หนองดินแดง;00105;นครปฐม;0006;124154242;xxxx;xx;1.7399E+12;นาย;007;เอกพล;ศรีพรหม;นาย เอกพล ศรีพรหม;0630600097;-;TH;P;12;2005-05-10T00:00:06;25;10;19;06;07;034286298;034286298;17;ส่งสินค้า;016;130;08;2024-09-29T10:56:18.019;10120;2024-10-03T13:32:02.433;7;0006;9;A;RE;0918;Aek;Sri;Aek Sri;-;038;M;006;xxx;03217;2040;38;0006;06;SC;SC07;SSC;xxxx;-;0006;xxxx;9;06;07;06;07;15;0504600139248;8;008;สำนักงานใหญ่;8;9;12;Car;New Car;7;Y;New Car;2471040031;7;10;78;1198;711933;PCX 113;9;7;7;7;112100.0007;94600.0007;6188.7907;88411.2107;13;49;1.1007;13.5607;13.2007;3292.0006;215.3607;3076.6407;138264.0007;9045.3107;129218.6907;7.0007;22.8482;11;12584;3198;อาจณรงค์ แก้วกรูด;อาจณรงค์;8;-;Sales Exec;-;35;034;ศูนย์อำนวยสินเชื่อนครปฐม;284;1116;1116 NAKHONPATHOM;9978;20;18;WEST;409;บจก. เกรียงไกร มอเตอร์เซลส์;KRIANGKRAIMOTORSALE CO., LTD.;Active;-;246;7007408;สนญ. เมืองสุพรรณบุรี;HO. MUANGSUPHANBURI;7;8;0124154243;2024-09-29T10:53:01.234;2023-12-07T00:00:07;9;1;2;3;4;5;2024-09-29T10:53:01.417;2024-09-29T10:56:55.197;2024-09-29T11:10:23.277;7;7;10;7;21;7;24;7;7;7;7;7;9999;chanidapha.k;ชณิดาภา แคล้วเครือ;7;7;7;2023-12-03T14:10:44.390;7;7;7;7;7;8;pada.l;8;008;สำนักงานใหญ่;17500.0007;7;459;yingyos.h;7;7;Normal;10;808;0.7;0.7;87312.0007;12;09;Electric Starter;08;Disc-Disc;09;Mag wheel;08;Automatic;167;2024-01-05T00:00:07;7;7;7;11;Central Area 1,9;7;Salary;27.4307;7;A;8;10;12000.0007;M;A;1.1007;7;018;A;Y;72007;7;9;2031-05-09T00:00:07;86;118;16;008;019;106;107;08;008;8;7;8;A;S;118;229;340;T;ABC;O;8;P;007;08;118;A;107;7;7;AAA;17;B;Y;7;8;5;10;11;12;C;Y;8;07;8;2024-10-02T11:53:59.430;07;0;0;0;0;A;0;08;800;93910.0004;Registered company - Permanent Staff;7;M;7;80;7;07;B;2.1004;1739902182419;2023-12-07T00:00:07;0;0;0.0000;0.0000;0.0000;0.0002;A;COS040 GenerateContract;2024-10-03T13:32:02.434;A;07;008;Dan3;Wen;7;007;107;B;80;008;BBB;FT;A;07;107;207;FF;M;พนัส;128;12-8;Company;130;7;OT;10;08;07;8;TR;07247;0814;55;73007;1241;007;8;T;07;80;Z;B;7;800;007;TR;MR;800;AA;207;Y;Y;Y;M;3429;0099;12/8;7;0008;xxx;007;NN;1006;0007;8;1008;Y;007;017;37;0504600139248;008;37;0008;10007;7;8;9;07;008;0009;107;207;307;407;N;12/8;8;7;None;3.6459;123;12;7;8;119;07;007;130;07254;หนองดินแดง;0814;เมืองนครปฐม;65;นครปฐม;73007;7;12;07;8;8;9;20;19;07254;หนองดินแดง;0814;เมืองนครปฐม;65;นครปฐม;73007;Comp;18;12;7;8;07;007;8;27;0814;หนองดินแดง;0794;เมืองนครปฐม;65;นครปฐม;73007;007;N;8;N;Y;Y;จันทร์จิรา;ตั้งต้น;9;พ่อ;0933018875;0985674543;นนทบุรี;07;007;0007;xxx;T;P;AA;07;N;Y;12/8;Y;สมชาย;M;0007;07;Comp;19;T;R;107;08;07;P;Y;017;119;07;07;107;130;10007;10006;120213;S;10006;Y;AA;23149;RR;TT;56;RF;0002;YY;999;BE;07;08;107;1007;117;Y;21328;41;0106;0095;Dan;ชลบุรี;009;A;AA;AAA;1210;RE;118;007;MISTER;RC;100006;BB;EM;0007;100007;-;0106;2007;5007;6007;N;106;1007;F;AA;AB;AC;1118;-;-;09328;3226;1129;40;A;O;QR;0328;07;77;AG;10007;14;07;007;F;017;0200;007;029;10006;Y;10006;0007;0929;07;1118;Y;07;FE;0000;7;10006;106;A;0219;0018;07;007;106;Dan;006;TU;SC;SSC;NG;0116;007;10006;90006;xxxx;06;07;6;7;0327;0649;-;1109;0006;T;C;C;0105;P;P;000;Y;N;RG;Y;Y;Y;N;Y;N;N;Y;Y;Y;N;Y;xxxx;0007;01016;462;Dan;xxx;-;AA;998;1240;0006;06;CF;xxx;-;AA;Y;N;Y;Y;Y;RE;7;10006;0006;16;Y;Y;N;Y;16;06;106;80;P;xxxx;10006;-;xxxx;0129;-;-;0006;7;เอก;906;-;xxxx;xxxx;xxxx;xxxx;xxxx;xxxx;xxxx;xxxx;xxxx;xxxx;xxxx;xxxx;xxxx;xxxx;;;;;;;;;
716714577;0123065712;MTR;09;0002;1011;AAM;1000;2;5;3;11;4;9;784;0814;A;5761;หนองดินแดง;00106;นครปฐม;0007;124154243;xxxx;xx;1.7399E+12;นางสาว;008;นงนภัส;แก้วไก่;นางสาว นงนภัส แก้วไก่;0630600098;-;TH;P;13;2005-05-10T00:00:07;26;11;19;07;08;034286299;034286299;18;ส่งสินค้า;017;131;09;2024-09-29T10:56:18.020;10121;2024-10-03T13:32:02.434;8;0007;10;A;FE;0919;Aek;Sri;Aek Sri;-;039;F;007;xxx;03218;2041;39;0007;07;SC;SC08;SSC;xxxx;-;0007;xxxx;10;07;08;07;08;16;0504600139249;9;009;สำนักงานใหญ่;9;10;13;Motorcycle;New Car;8;Y;New Car;2471040032;8;11;79;1199;711934;PCX 114;10;8;8;8;112100.0008;94600.0008;6188.7908;88411.2108;14;50;1.1008;13.5608;13.2008;3292.0007;215.3608;3076.6408;138264.0008;9045.3108;129218.6908;7.0008;22.8483;12;12585;3199;อาจณรงค์ แก้วกรูด;อาจณรงค์;9;-;Sales Exec;-;36;035;ศูนย์อำนวยสินเชื่อนครปฐม;285;1117;1117 NAKHONPATHOM;9979;21;19;WEST;410;บจก. เกรียงไกร มอเตอร์เซลส์;KRIANGKRAIMOTORSALE CO., LTD.;Active;-;247;7007409;สนญ. เมืองสุพรรณบุรี;HO. MUANGSUPHANBURI;8;9;0124154244;2024-09-29T10:53:01.235;2023-12-07T00:00:08;10;1;2;3;4;5;2024-09-29T10:53:01.418;2024-09-29T10:56:55.198;2024-09-29T11:10:23.278;8;8;11;8;22;8;25;8;8;8;8;8;10000;chanidapha.k;ชณิดาภา แคล้วเครือ;8;8;8;2023-12-03T14:10:44.391;8;8;8;8;8;9;pada.l;9;009;สำนักงานใหญ่;17500.0008;8;460;yingyos.h;8;8;Normal;11;809;0.8;0.8;87312.0008;13;10;Electric Starter;09;Disc-Disc;10;Mag wheel;09;Automatic;168;2024-01-05T00:00:08;8;8;8;12;Central Area 1,10;8;Salary;27.4308;8;A;9;11;12000.0008;M;A;1.1008;8;019;A;Y;72008;8;10;2031-05-09T00:00:08;87;119;17;009;020;107;108;09;009;9;8;9;A;S;119;230;341;T;ABC;O;9;P;008;09;119;A;108;8;8;AAA;18;A;Y;8;9;6;11;12;13;C;Y;9;08;9;2024-10-02T11:53:59.431;08;0;0;0;0;A;0;09;900;93910.0005;Registered company - Permanent Staff;8;T;8;90;8;08;A;2.1005;1739902182420;2023-12-07T00:00:08;0;0;0.0000;0.0000;0.0000;0.0003;A;COS040 GenerateContract;2024-10-03T13:32:02.435;A;08;009;Dan;Wen;8;008;108;C;90;009;CCC;MT;A;08;108;208;TT;F;พนัส;129;12-9;Company;131;8;OT;11;09;08;9;TR;07247;0815;55;73008;1242;008;9;S;08;90;A;B;8;900;008;TR;MR;900;BB;208;Y;N;N;T;3430;0099;12/9;8;0009;xxx;008;YY;1007;0008;9;1009;N;008;018;38;0504600139249;009;38;0009;10008;8;9;10;08;009;0010;108;208;308;408;N;12/9;9;8;None;3.6460;124;13;8;9;120;08;008;131;07255;หนองดินแดง;0815;เมืองนครปฐม;66;นครปฐม;73008;8;13;08;9;9;10;21;20;07255;หนองดินแดง;0815;เมืองนครปฐม;66;นครปฐม;73008;Comp;19;13;8;9;08;008;9;28;0815;หนองดินแดง;0795;เมืองนครปฐม;66;นครปฐม;73008;008;N;9;N;Y;Y;จันทร์จิรา;ตั้งต้น;10;แม่;0933018876;0985674544;นนทบุรี;08;008;0008;xxx;Y;P;AA;08;Y;N;12/9;Y;สมปอง;M;0008;08;Comp;20;T;R;108;09;08;P;Y;018;120;08;08;108;131;10008;10007;120213;S;10007;Y;AA;23150;RR;TT;57;RF;0003;YY;1000;BE;08;09;108;1008;118;Y;21329;42;0107;0096;Dan;ชลบุรี;010;A;AA;AAA;1211;RE;119;008;MISS;QE;100007;AA;LD;0008;100008;-;0107;2008;5008;6008;Y;107;1008;F;AA;AB;AC;1119;-;-;09329;3227;1130;41;A;O;TR;0329;08;88;AG;10008;15;08;008;F;018;0201;008;030;10007;T;10007;0008;0930;08;1119;Y;08;RE;0000;8;10007;107;A;0220;0019;08;008;107;Dan;007;TU;SC;SSC;NG;0117;008;10007;90007;xxxx;07;08;7;8;0328;0650;-;1110;0007;C;T;C;0106;F;F;000;N;Y;RG;N;Y;Y;N;Y;N;N;Y;Y;Y;N;Y;xxxx;0008;01017;463;Dan;xxx;-;AA;999;1241;0007;07;CF;xxx;-;AA;Y;N;Y;Y;Y;RE;8;10007;0007;17;Y;Y;N;Y;17;07;107;90;P;xxxx;10007;-;xxxx;0130;-;-;0007;8;เอก;907;-;xxxx;xxxx;xxxx;xxxx;xxxx;xxxx;xxxx;xxxx;xxxx;xxxx;xxxx;xxxx;xxxx;xxxx;;;;;;;;;
906383135;0124058860;MTR;10;0003;1012;LCG;999;1;2;4;11;5;10;785;0815;A;5762;หนองดินแดง;00107;นครปฐม;0008;124154244;xxxx;xx;1.7399E+12;นาง;009;ศศิธร;จำปา;นางศศิธร จำปา;0630600099;-;TH;P;14;2005-05-10T00:00:08;27;12;19;08;09;034286300;034286300;19;ส่งสินค้า;018;132;10;2024-09-29T10:56:18.021;10122;2024-10-03T13:32:02.435;9;0008;11;A;RE;0920;Aek;Sri;Aek Sri;-;040;F;008;xxx;03219;2042;40;0008;08;SC;SC09;SSC;xxxx;-;0008;xxxx;11;08;09;08;09;17;0504600139250;10;010;สำนักงานใหญ่;10;11;14;Car;New Car;9;Y;New Car;2471040033;9;12;80;1200;711935;PCX 115;11;9;9;9;112100.0009;94600.0009;6188.7909;88411.2109;15;51;1.1009;13.5609;13.2009;3292.0008;215.3609;3076.6409;138264.0009;9045.3109;129218.6909;7.0009;22.8484;13;12586;3200;อาจณรงค์ แก้วกรูด;อาจณรงค์;10;-;Sales Exec;-;37;036;ศูนย์อำนวยสินเชื่อนครปฐม;286;1118;1118 NAKHONPATHOM;9980;22;20;WEST;411;บจก. เกรียงไกร มอเตอร์เซลส์;KRIANGKRAIMOTORSALE CO., LTD.;Active;-;248;7007410;สนญ. เมืองสุพรรณบุรี;HO. MUANGSUPHANBURI;9;10;0124154245;2024-09-29T10:53:01.236;2023-12-07T00:00:09;11;1;2;3;4;5;2024-09-29T10:53:01.419;2024-09-29T10:56:55.199;2024-09-29T11:10:23.279;9;9;12;9;23;9;26;9;9;9;9;9;10001;chanidapha.k;ชณิดาภา แคล้วเครือ;9;9;9;2023-12-03T14:10:44.392;9;9;9;9;9;10;pada.l;10;010;สำนักงานใหญ่;17500.0009;9;461;yingyos.h;9;9;Normal;12;810;0.9;0.9;87312.0009;14;11;Electric Starter;10;Disc-Disc;11;Mag wheel;10;Automatic;169;2024-01-05T00:00:09;9;9;9;13;Central Area 1,11;9;Salary;27.4309;9;A;10;12;12000.0009;M;A;1.1009;9;020;A;Y;72009;9;11;2031-05-09T00:00:09;88;120;18;010;021;108;109;10;010;10;9;10;A;S;120;231;342;T;ABC;O;10;P;009;10;120;A;109;9;9;AAA;19;B;Y;9;10;7;12;13;14;C;Y;10;09;10;2024-10-02T11:53:59.432;09;0;0;0;0;A;0;10;1000;93910.0006;Registered company - Permanent Staff;9;N;9;100;9;09;B;2.1006;1739902182421;2023-12-07T00:00:09;0;0;0.0000;0.0000;0.0000;0.0004;A;COS040 GenerateContract;2024-10-03T13:32:02.436;A;09;010;Dan4;Wen;9;009;109;A;100;010;AAA;FT;A;09;109;209;FF;M;พนัส;130;12-10;Company;132;9;OT;12;10;09;10;TR;07247;0816;55;73009;1243;009;10;T;09;100;Z;B;9;1000;009;TR;MR;1000;CC;209;N;N;N;M;3431;0099;12/10;9;0010;xxx;009;NN;1008;0009;10;1010;Y;009;019;39;0504600139250;010;39;0010;10009;9;10;11;09;010;0011;109;209;309;409;N;12/10;10;9;None;3.6461;125;14;9;10;121;09;009;132;07256;หนองดินแดง;0816;เมืองนครปฐม;67;นครปฐม;73009;9;14;09;10;10;11;22;21;07256;หนองดินแดง;0816;เมืองนครปฐม;67;นครปฐม;73009;Comp;20;14;9;10;09;009;10;29;0816;หนองดินแดง;0796;เมืองนครปฐม;67;นครปฐม;73009;009;N;10;N;Y;Y;จันทร์จิรา;ตั้งต้น;11;พ่อ;0933018877;0985674545;นนทบุรี;09;009;0009;xxx;T;F;AA;09;N;Y;12/10;Y;สมใจ;M;0009;09;Comp;21;T;R;109;10;09;P;Y;019;121;09;09;109;132;10009;10008;120213;S;10008;Y;AA;23151;RR;TT;58;RF;0000;YY;1001;BE;09;10;109;1009;119;Y;21330;43;0108;0097;Dan;ชลบุรี;011;A;AA;AAA;1212;RE;120;009;MISTER;RC;100008;BB;EM;0009;100009;-;0108;2009;5009;6009;N;108;1009;F;AA;AB;AC;1120;-;-;09330;3228;1131;42;A;O;QR;0330;09;99;AG;10009;16;09;009;F;019;0202;009;031;10008;Y;10008;0009;0931;09;1120;Y;09;FE;0000;9;10008;108;A;0221;0020;09;009;108;Dan;008;TU;SC;SSC;NG;0118;009;10008;90008;xxxx;08;09;8;9;0329;0651;-;1111;0008;T;C;C;0107;P;P;000;Y;N;RG;Y;Y;Y;N;Y;N;N;Y;Y;Y;N;Y;xxxx;0009;01018;464;Dan;xxx;-;AA;1000;1242;0008;08;CF;xxx;-;AA;Y;N;Y;Y;Y;RE;9;10008;0008;18;Y;Y;N;Y;18;08;108;100;P;xxxx;10008;-;xxxx;0131;-;-;0008;9;เอก;908;-;xxxx;xxxx;xxxx;xxxx;xxxx;xxxx;xxxx;xxxx;xxxx;xxxx;xxxx;xxxx;xxxx;xxxx;;;;;;;;;
426393326;0124058860;MTR;11;0004;1010;AAM;1000;2;3;5;12;6;11;786;0816;A;5763;หนองดินแดง;00108;นครปฐม;0009;124154245;xxxx;xx;1.7399E+12;นาย;010;เอกพล;ศรีพรหม;นาย เอกพล ศรีพรหม;0630600100;-;TH;P;15;2005-05-10T00:00:09;28;13;19;09;10;034286301;034286301;20;ส่งสินค้า;019;133;11;2024-09-29T10:56:18.022;10123;2024-10-03T13:32:02.436;10;0009;12;A;FE;0921;Aek;Sri;Aek Sri;-;041;M;009;xxx;03220;2043;41;0009;09;SC;SC10;SSC;xxxx;-;0009;xxxx;12;09;10;09;10;18;0504600139251;11;011;สำนักงานใหญ่;11;12;15;Motorcycle;New Car;10;Y;New Car;2471040034;10;13;81;1201;711936;PCX 116;12;10;10;10;112100.0010;94600.0010;6188.7910;88411.2110;16;52;1.1010;13.5610;13.2010;3292.0009;215.3610;3076.6410;138264.0010;9045.3110;129218.6910;7.0010;22.8485;14;12587;3201;อาจณรงค์ แก้วกรูด;อาจณรงค์;11;-;Sales Exec;-;38;037;ศูนย์อำนวยสินเชื่อนครปฐม;287;1119;1119 NAKHONPATHOM;9981;23;21;WEST;412;บจก. เกรียงไกร มอเตอร์เซลส์;KRIANGKRAIMOTORSALE CO., LTD.;Active;-;249;7007411;สนญ. เมืองสุพรรณบุรี;HO. MUANGSUPHANBURI;10;11;0124154246;2024-09-29T10:53:01.237;2023-12-07T00:00:10;12;1;2;3;4;5;2024-09-29T10:53:01.420;2024-09-29T10:56:55.200;2024-09-29T11:10:23.280;10;10;13;10;24;10;27;10;10;10;10;10;10002;chanidapha.k;ชณิดาภา แคล้วเครือ;10;10;10;2023-12-03T14:10:44.393;10;10;10;10;10;11;pada.l;11;011;สำนักงานใหญ่;17500.0010;10;462;yingyos.h;10;10;Normal;13;811;0.10;0.10;87312.0010;15;12;Electric Starter;11;Disc-Disc;12;Mag wheel;11;Automatic;170;2024-01-05T00:00:10;10;10;10;14;Central Area 1,12;10;Salary;27.4310;10;A;11;13;12000.0010;M;A;1.1010;10;021;A;Y;72010;10;12;2031-05-09T00:00:10;89;121;19;011;022;109;110;11;011;11;10;11;A;S;121;232;343;T;ABC;O;11;P;010;11;121;A;110;10;10;AAA;20;A;Y;10;11;8;13;14;15;C;Y;11;10;11;2024-10-02T11:53:59.433;10;0;0;0;0;A;0;11;1100;93910.0007;Registered company - Permanent Staff;10;M;10;110;10;10;A;2.1007;1739902182422;2023-12-07T00:00:10;0;0;0.0000;0.0000;0.0000;0.0005;A;COS040 GenerateContract;2024-10-03T13:32:02.437;A;10;011;Dan;Wen;10;010;110;B;110;011;BBB;MT;A;10;110;210;TT;F;พนัส;131;12-11;Company;133;10;OT;13;11;10;11;TR;07247;0817;55;73010;1244;010;11;S;10;110;A;B;10;1100;010;TR;MR;1100;CC;210;N;Y;Y;T;3432;0099;12/11;10;0011;xxx;010;YY;1009;0010;11;1011;N;010;020;40;0504600139251;011;40;0011;10010;10;11;12;10;011;0012;110;210;310;410;N;12/11;11;10;None;3.6462;126;15;10;11;122;10;010;133;07257;หนองดินแดง;0817;เมืองนครปฐม;68;นครปฐม;73010;10;15;10;11;11;12;23;22;07257;หนองดินแดง;0817;เมืองนครปฐม;68;นครปฐม;73010;Comp;21;15;10;11;10;010;11;30;0817;หนองดินแดง;0797;เมืองนครปฐม;68;นครปฐม;73010;010;N;11;N;Y;Y;จันทร์จิรา;ตั้งต้น;12;แม่;0933018878;0985674546;นนทบุรี;10;010;0010;xxx;Y;F;AA;10;Y;N;12/11;Y;สมชาย;M;0010;10;Comp;22;T;R;110;11;10;P;Y;020;122;10;10;110;133;10010;10009;120213;S;10009;Y;AA;23152;RR;TT;59;RF;0001;YY;1002;BE;10;11;110;1010;120;Y;21331;44;0109;0098;Dan;ชลบุรี;012;A;AA;AAA;1213;RE;121;010;MISTER;QE;100009;AA;LD;0010;100010;-;0109;2010;5010;6010;Y;109;1010;F;AA;AB;AC;1121;-;-;09331;3229;1132;43;A;O;TR;0331;10;110;AG;10010;17;10;010;F;020;0203;010;032;10009;T;10009;0010;0932;10;1121;Y;10;RE;0000;10;10009;109;A;0222;0021;10;010;109;Dan;009;TU;SC;SSC;NG;0119;010;10009;90009;xxxx;09;10;9;10;0330;0652;-;1112;0009;C;T;C;0108;F;F;000;N;Y;RG;N;Y;Y;N;Y;N;N;Y;Y;Y;N;Y;xxxx;0010;01019;465;Dan;xxx;-;AA;1001;1243;0009;09;CF;xxx;-;AA;Y;N;Y;Y;Y;RE;10;10009;0009;19;Y;Y;N;Y;19;09;109;110;P;xxxx;10009;-;xxxx;0132;-;-;0009;10;เอก;909;-;xxxx;xxxx;xxxx;xxxx;xxxx;xxxx;xxxx;xxxx;xxxx;xxxx;xxxx;xxxx;xxxx;xxxx;;;;;;;;;
20290927150002;0123065712;MTR;12;0000;1011;LCG;999;1;4;1;12;2;12;787;0817;A;5764;หนองดินแดง;00109;นครปฐม;0010;124154246;xxxx;xx;1.7399E+12;นางสาว;011;นงนภัส;แก้วไก่;นางสาว นงนภัส แก้วไก่;0630600101;-;TH;P;16;2005-05-10T00:00:10;29;14;19;10;11;034286302;034286302;21;ส่งสินค้า;020;134;12;2024-09-29T10:56:18.023;10124;2024-10-03T13:32:02.437;11;0010;13;A;RE;0922;Aek;Sri;Aek Sri;-;042;F;010;xxx;03221;2044;42;0010;10;SC;SC11;SSC;xxxx;-;0010;xxxx;13;10;11;10;11;19;0504600139252;12;012;สำนักงานใหญ่;12;13;16;Motorcycle;New Car;11;Y;New Car;2471040035;11;14;82;1202;711937;PCX 117;13;11;11;11;112100.0011;94600.0011;6188.7911;88411.2111;17;53;1.1011;13.5611;13.2011;3292.0010;215.3611;3076.6411;138264.0011;9045.3111;129218.6911;7.0011;22.8486;15;12588;3202;อาจณรงค์ แก้วกรูด;อาจณรงค์;12;-;Sales Exec;-;39;038;ศูนย์อำนวยสินเชื่อนครปฐม;288;1120;1120 NAKHONPATHOM;9982;24;22;WEST;413;บจก. เกรียงไกร มอเตอร์เซลส์;KRIANGKRAIMOTORSALE CO., LTD.;Active;-;250;7007412;สนญ. เมืองสุพรรณบุรี;HO. MUANGSUPHANBURI;11;12;0124154247;2024-09-29T10:53:01.238;2023-12-07T00:00:11;13;1;2;3;4;5;2024-09-29T10:53:01.421;2024-09-29T10:56:55.201;2024-09-29T11:10:23.281;11;11;14;11;25;11;28;11;11;11;11;11;10003;chanidapha.k;ชณิดาภา แคล้วเครือ;11;11;11;2023-12-03T14:10:44.394;11;11;11;11;11;12;pada.l;12;012;สำนักงานใหญ่;17500.0011;11;463;yingyos.h;11;11;Normal;14;812;0.11;0.11;87312.0011;16;13;Electric Starter;12;Disc-Disc;13;Mag wheel;12;Automatic;171;2024-01-05T00:00:11;11;11;11;15;Central Area 1,13;11;Salary;27.4311;11;A;12;14;12000.0011;M;A;1.1011;11;022;A;Y;72011;11;13;2031-05-09T00:00:11;90;122;20;012;023;110;111;12;012;12;11;12;A;S;122;233;344;T;ABC;O;12;P;011;12;122;A;111;11;11;AAA;21;B;Y;11;12;9;14;15;16;C;Y;12;11;12;2024-10-02T11:53:59.434;11;0;0;0;0;A;0;12;1200;93910.0008;Registered company - Permanent Staff;11;T;11;120;11;11;B;2.1008;1739902182423;2023-12-07T00:00:11;0;0;0.0000;0.0000;0.0000;0.0006;A;COS040 GenerateContract;2024-10-03T13:32:02.438;A;11;012;Dan4;Wen;11;011;111;C;120;012;CCC;FT;A;11;111;211;FF;M;พนัส;132;12-12;Company;134;11;OT;14;12;11;12;TR;07247;0818;55;73011;1245;011;12;T;11;120;Z;B;11;1200;011;TR;MR;1200;AA;211;N;N;Y;M;3433;0099;12/12;11;0012;xxx;011;NN;1010;0011;12;1012;Y;011;021;41;0504600139252;012;41;0012;10011;11;12;13;11;012;0013;111;211;311;411;N;12/12;12;11;None;3.6463;127;16;11;12;123;11;011;134;07258;หนองดินแดง;0818;เมืองนครปฐม;69;นครปฐม;73011;11;16;11;12;12;13;24;23;07258;หนองดินแดง;0818;เมืองนครปฐม;69;นครปฐม;73011;Comp;22;16;11;12;11;011;12;31;0818;หนองดินแดง;0798;เมืองนครปฐม;69;นครปฐม;73011;011;N;12;N;Y;Y;จันทร์จิรา;ตั้งต้น;13;พ่อ;0933018879;0985674547;นนทบุรี;11;011;0011;xxx;T;P;AA;11;N;Y;12/12;Y;สมปอง;M;0011;11;Comp;23;T;R;111;12;11;P;Y;021;123;11;11;111;134;10011;10010;120213;S;10010;Y;AA;23153;RR;TT;60;RF;0002;YY;1003;BE;11;12;111;1011;121;Y;21332;45;0110;0099;Dan;ชลบุรี;013;A;AA;AAA;1214;RE;122;011;MISTER;RC;100010;BB;EM;0011;100011;-;0110;2011;5011;6011;N;110;1011;F;AA;AB;AC;1122;-;-;09332;3230;1133;44;A;O;QR;0332;11;121;AG;10011;18;11;011;F;021;0204;011;033;10010;Y;10010;0011;0933;11;1122;Y;11;FE;0000;11;10010;110;A;0223;0022;11;011;110;Dan;010;TU;SC;SSC;NG;0120;011;10010;90010;xxxx;10;11;10;11;0331;0653;-;1113;0010;T;C;C;0109;P;P;000;Y;N;RG;Y;Y;Y;N;Y;N;N;Y;Y;Y;N;Y;xxxx;0011;01020;466;Dan;xxx;-;AA;1002;1244;0010;10;CF;xxx;-;AA;Y;N;Y;Y;Y;RE;11;10010;0010;20;Y;Y;N;Y;20;10;110;120;P;xxxx;10010;-;xxxx;0133;-;-;0010;11;เอก;910;-;xxxx;xxxx;xxxx;xxxx;xxxx;xxxx;xxxx;xxxx;xxxx;xxxx;xxxx;xxxx;xxxx;xxxx;;;;;;;;;
20241024_131739;0124058860;MTR;13;0001;1012;AAM;1000;2;5;2;12;3;13;788;0818;A;5765;หนองดินแดง;00110;นครปฐม;0011;124154247;xxxx;xx;1.7399E+12;นาง;012;ศศิธร;จำปา;นางศศิธร จำปา;0630600102;-;TH;P;17;2005-05-10T00:00:11;30;15;19;11;12;034286303;034286303;22;ส่งสินค้า;021;135;13;2024-09-29T10:56:18.024;10125;2024-10-03T13:32:02.438;12;0011;14;A;FE;0923;Aek;Sri;Aek Sri;-;043;F;011;xxx;03222;2045;43;0011;11;SC;SC12;SSC;xxxx;-;0011;xxxx;14;11;12;11;12;20;0504600139253;13;013;สำนักงานใหญ่;13;14;17;Motorcycle;New Car;12;Y;New Car;2471040036;12;15;83;1203;711938;PCX 118;14;12;12;12;112100.0012;94600.0012;6188.7912;88411.2112;18;54;1.1012;13.5612;13.2012;3292.0011;215.3612;3076.6412;138264.0012;9045.3112;129218.6912;7.0012;22.8487;16;12589;3203;อาจณรงค์ แก้วกรูด;อาจณรงค์;13;-;Sales Exec;-;40;039;ศูนย์อำนวยสินเชื่อนครปฐม;289;1121;1121 NAKHONPATHOM;9983;25;23;WEST;414;บจก. เกรียงไกร มอเตอร์เซลส์;KRIANGKRAIMOTORSALE CO., LTD.;Active;-;251;7007413;สนญ. เมืองสุพรรณบุรี;HO. MUANGSUPHANBURI;12;13;0124154248;2024-09-29T10:53:01.239;2023-12-07T00:00:12;14;1;2;3;4;5;2024-09-29T10:53:01.422;2024-09-29T10:56:55.202;2024-09-29T11:10:23.282;12;12;15;12;26;12;29;12;12;12;12;12;10004;chanidapha.k;ชณิดาภา แคล้วเครือ;12;12;12;2023-12-03T14:10:44.395;12;12;12;12;12;13;pada.l;13;013;สำนักงานใหญ่;17500.0012;12;464;yingyos.h;12;12;Normal;15;813;0.12;0.12;87312.0012;17;14;Electric Starter;13;Disc-Disc;14;Mag wheel;13;Automatic;172;2024-01-05T00:00:12;12;12;12;16;Central Area 1,14;12;Salary;27.4312;12;A;13;15;12000.0012;M;A;1.1012;12;023;A;Y;72012;12;14;2031-05-09T00:00:12;91;123;21;013;024;111;112;13;013;13;12;13;A;S;123;234;345;T;ABC;O;13;P;012;13;123;A;112;12;12;AAA;22;A;Y;12;13;10;15;16;17;C;Y;13;12;13;2024-10-02T11:53:59.435;12;0;0;0;0;A;0;13;1300;93910.0009;Registered company - Permanent Staff;12;N;12;130;12;12;A;2.1009;1739902182424;2023-12-07T00:00:12;0;0;0.0000;0.0000;0.0000;0.0007;A;COS040 GenerateContract;2024-10-03T13:32:02.439;A;12;013;Dan;Wen;12;012;112;A;130;013;AAA;MT;A;12;112;212;TT;F;พนัส;133;12-13;Company;135;12;OT;15;13;12;13;TR;07247;0819;55;73012;1246;012;13;S;12;130;A;B;12;1300;012;TR;MR;1300;BB;212;Y;N;N;T;3434;0099;12/13;12;0013;xxx;012;YY;1011;0012;13;1013;N;012;022;42;0504600139253;013;42;0013;10012;12;13;14;12;013;0014;112;212;312;412;N;12/13;13;12;None;3.6464;128;17;12;13;124;12;012;135;07259;หนองดินแดง;0819;เมืองนครปฐม;70;นครปฐม;73012;12;17;12;13;13;14;25;24;07259;หนองดินแดง;0819;เมืองนครปฐม;70;นครปฐม;73012;Comp;23;17;12;13;12;012;13;32;0819;หนองดินแดง;0799;เมืองนครปฐม;70;นครปฐม;73012;012;N;13;N;Y;Y;จันทร์จิรา;ตั้งต้น;14;แม่;0933018880;0985674548;นนทบุรี;12;012;0012;xxx;Y;P;AA;12;Y;N;12/13;Y;สมใจ;M;0012;12;Comp;24;T;R;112;13;12;P;Y;022;124;12;12;112;135;10012;10011;120213;S;10011;Y;AA;23154;RR;TT;61;RF;0003;YY;1004;BE;12;13;112;1012;122;Y;21333;46;0111;0100;Dan;ชลบุรี;014;A;AA;AAA;1215;RE;123;012;MISTER;QE;100011;AA;LD;0012;100012;-;0111;2012;5012;6012;Y;111;1012;F;AA;AB;AC;1123;-;-;09333;3231;1134;45;A;O;TR;0333;12;132;AG;10012;19;12;012;F;022;0205;012;034;10011;T;10011;0012;0934;12;1123;Y;12;RE;0000;12;10011;111;A;0224;0023;12;012;111;Dan;011;TU;SC;SSC;NG;0121;012;10011;90011;xxxx;11;12;11;12;0332;0654;-;1114;0011;C;T;C;0110;F;F;000;N;Y;RG;N;Y;Y;N;Y;N;N;Y;Y;Y;N;Y;xxxx;0012;01021;467;Dan;xxx;-;AA;1003;1245;0011;11;CF;xxx;-;AA;Y;N;Y;Y;Y;RE;12;10011;0011;21;Y;Y;N;Y;21;11;111;130;P;xxxx;10011;-;xxxx;0134;-;-;0011;12;เอก;911;-;xxxx;xxxx;xxxx;xxxx;xxxx;xxxx;xxxx;xxxx;xxxx;xxxx;xxxx;xxxx;xxxx;xxxx;;;;;;;;;
716714577;0123065712;MTR;14;0002;1010;LCG;999;1;2;3;12;4;14;789;0819;A;5766;หนองดินแดง;00111;นครปฐม;0012;124154248;xxxx;xx;1.7399E+12;นาย;013;เอกพล;ศรีพรหม;นาย เอกพล ศรีพรหม;0630600103;-;TH;P;18;2005-05-10T00:00:12;31;16;19;12;13;034286304;034286304;23;ส่งสินค้า;022;136;14;2024-09-29T10:56:18.025;10126;2024-10-03T13:32:02.439;13;0012;15;A;RE;0924;Aek;Sri;Aek Sri;-;044;M;012;xxx;03223;2046;44;0012;12;SC;SC13;SSC;xxxx;-;0012;xxxx;15;12;13;12;13;21;0504600139254;14;014;สำนักงานใหญ่;14;15;18;Car;New Car;13;Y;New Car;2471040037;13;16;84;1204;711939;PCX 119;15;13;13;13;112100.0013;94600.0013;6188.7913;88411.2113;19;55;1.1013;13.5613;13.2013;3292.0012;215.3613;3076.6413;138264.0013;9045.3113;129218.6913;7.0013;22.8488;17;12590;3204;อาจณรงค์ แก้วกรูด;อาจณรงค์;14;-;Sales Exec;-;41;040;ศูนย์อำนวยสินเชื่อนครปฐม;290;1122;1122 NAKHONPATHOM;9984;26;24;WEST;415;บจก. เกรียงไกร มอเตอร์เซลส์;KRIANGKRAIMOTORSALE CO., LTD.;Active;-;252;7007414;สนญ. เมืองสุพรรณบุรี;HO. MUANGSUPHANBURI;13;14;0124154249;2024-09-29T10:53:01.240;2023-12-07T00:00:13;15;1;2;3;4;5;2024-09-29T10:53:01.423;2024-09-29T10:56:55.203;2024-09-29T11:10:23.283;13;13;16;13;27;13;30;13;13;13;13;13;10005;chanidapha.k;ชณิดาภา แคล้วเครือ;13;13;13;2023-12-03T14:10:44.396;13;13;13;13;13;14;pada.l;14;014;สำนักงานใหญ่;17500.0013;13;465;yingyos.h;13;13;Normal;16;814;0.13;0.13;87312.0013;18;15;Electric Starter;14;Disc-Disc;15;Mag wheel;14;Automatic;173;2024-01-05T00:00:13;13;13;13;17;Central Area 1,15;13;Salary;27.4313;13;A;14;16;12000.0013;M;A;1.1013;13;024;A;Y;72013;13;15;2031-05-09T00:00:13;92;124;22;014;025;112;113;14;014;14;13;14;A;S;124;235;346;T;ABC;O;14;P;013;14;124;A;113;13;13;AAA;23;B;Y;13;14;11;16;17;18;C;Y;14;13;14;2024-10-02T11:53:59.436;13;0;0;0;0;A;0;14;1400;93910.0010;Registered company - Permanent Staff;13;M;13;140;13;13;B;2.1010;1739902182425;2023-12-07T00:00:13;0;0;0.0000;0.0000;0.0000;0.0008;A;COS040 GenerateContract;2024-10-03T13:32:02.440;A;13;014;Dan5;Wen;13;013;113;B;140;014;BBB;FT;A;13;113;213;FF;M;พนัส;134;12-14;Company;136;13;OT;16;14;13;14;TR;07247;0820;55;73013;1247;013;14;T;13;140;Z;B;13;1400;013;TR;MR;1400;CC;213;Y;Y;N;M;3435;0099;12/14;13;0014;xxx;013;NN;1012;0013;14;1014;Y;013;023;43;0504600139254;014;43;0014;10013;13;14;15;13;014;0015;113;213;313;413;N;12/14;14;13;None;3.6465;129;18;13;14;125;13;013;136;07260;หนองดินแดง;0820;เมืองนครปฐม;71;นครปฐม;73013;13;18;13;14;14;15;26;25;07260;หนองดินแดง;0820;เมืองนครปฐม;71;นครปฐม;73013;Comp;24;18;13;14;13;013;14;33;0820;หนองดินแดง;0800;เมืองนครปฐม;71;นครปฐม;73013;013;N;14;N;Y;Y;จันทร์จิรา;ตั้งต้น;15;พ่อ;0933018881;0985674549;นนทบุรี;13;013;0013;xxx;T;F;AA;13;N;Y;12/14;Y;สมชาย;M;0013;13;Comp;25;T;R;113;14;13;P;Y;023;125;13;13;113;136;10013;10012;120213;S;10012;Y;AA;23155;RR;TT;62;RF;0000;YY;1005;BE;13;14;113;1013;123;Y;21334;47;0112;0101;Dan;ชลบุรี;015;A;AA;AAA;1216;RE;124;013;MISS;RC;100012;BB;EM;0013;100013;-;0112;2013;5013;6013;N;112;1013;F;AA;AB;AC;1124;-;-;09334;3232;1135;46;A;O;QR;0334;13;143;AG;10013;20;13;013;F;023;0206;013;035;10012;Y;10012;0013;0935;13;1124;Y;13;FE;0000;13;10012;112;A;0225;0024;13;013;112;Dan;012;TU;SC;SSC;NG;0122;013;10012;90012;xxxx;12;13;12;13;0333;0655;-;1115;0012;T;C;C;0111;P;P;000;Y;N;RG;Y;Y;Y;N;Y;N;N;Y;Y;Y;N;Y;xxxx;0013;01022;468;Dan;xxx;-;AA;1004;1246;0012;12;CF;xxx;-;AA;Y;N;Y;Y;Y;RE;13;10012;0012;22;Y;Y;N;Y;22;12;112;140;P;xxxx;10012;-;xxxx;0135;-;-;0012;13;เอก;912;-;xxxx;xxxx;xxxx;xxxx;xxxx;xxxx;xxxx;xxxx;xxxx;xxxx;xxxx;xxxx;xxxx;xxxx;;;;;;;;;
906383135;0124058860;MTR;15;0003;1011;AAM;1000;2;3;4;12;5;15;790;0820;A;5767;หนองดินแดง;00112;นครปฐม;0013;124154249;xxxx;xx;1.7399E+12;นางสาว;014;นงนภัส;แก้วไก่;นางสาว นงนภัส แก้วไก่;0630600104;-;TH;P;19;2005-05-10T00:00:13;32;17;19;13;14;034286305;034286305;24;ส่งสินค้า;023;137;15;2024-09-29T10:56:18.026;10127;2024-10-03T13:32:02.440;14;0013;16;A;FE;0925;Aek;Sri;Aek Sri;-;045;F;013;xxx;03224;2047;45;0013;13;SC;SC14;SSC;xxxx;-;0013;xxxx;16;13;14;13;14;22;0504600139255;15;015;สำนักงานใหญ่;15;16;19;Motorcycle;New Car;14;Y;New Car;2471040038;14;17;85;1205;711940;PCX 120;16;14;14;14;112100.0014;94600.0014;6188.7914;88411.2114;20;56;1.1014;13.5614;13.2014;3292.0013;215.3614;3076.6414;138264.0014;9045.3114;129218.6914;7.0014;22.8489;18;12591;3205;อาจณรงค์ แก้วกรูด;อาจณรงค์;15;-;Sales Exec;-;42;041;ศูนย์อำนวยสินเชื่อนครปฐม;291;1123;1123 NAKHONPATHOM;9985;27;25;WEST;416;บจก. เกรียงไกร มอเตอร์เซลส์;KRIANGKRAIMOTORSALE CO., LTD.;Active;-;253;7007415;สนญ. เมืองสุพรรณบุรี;HO. MUANGSUPHANBURI;14;15;0124154250;2024-09-29T10:53:01.241;2023-12-07T00:00:14;16;1;2;3;4;5;2024-09-29T10:53:01.424;2024-09-29T10:56:55.204;2024-09-29T11:10:23.284;14;14;17;14;28;14;31;14;14;14;14;14;10006;chanidapha.k;ชณิดาภา แคล้วเครือ;14;14;14;2023-12-03T14:10:44.397;14;14;14;14;14;15;pada.l;15;015;สำนักงานใหญ่;17500.0014;14;466;yingyos.h;14;14;Normal;17;815;0.14;0.14;87312.0014;19;16;Electric Starter;15;Disc-Disc;16;Mag wheel;15;Automatic;174;2024-01-05T00:00:14;14;14;14;18;Central Area 1,16;14;Salary;27.4314;14;A;15;17;12000.0014;M;A;1.1014;14;025;A;Y;72014;14;16;2031-05-09T00:00:14;93;125;23;015;026;113;114;15;015;15;14;15;A;S;125;236;347;T;ABC;O;15;P;014;15;125;A;114;14;14;AAA;24;A;Y;14;15;12;17;18;19;C;Y;15;14;15;2024-10-02T11:53:59.437;14;0;0;0;0;A;0;15;1500;93910.0011;Registered company - Permanent Staff;14;T;14;150;14;14;A;2.1011;1739902182426;2023-12-07T00:00:14;0;0;0.0000;0.0000;0.0000;0.0009;A;COS040 GenerateContract;2024-10-03T13:32:02.441;A;14;015;Dan;Wen;14;014;114;C;150;015;CCC;MT;A;14;114;214;TT;F;พนัส;135;12-15;Company;137;14;OT;17;15;14;15;TR;07247;0821;55;73014;1248;014;15;S;14;150;A;B;14;1500;014;TR;MR;1500;CC;214;Y;N;Y;T;3436;0099;12/15;14;0015;xxx;014;YY;1013;0014;15;1015;N;014;024;44;0504600139255;015;44;0015;10014;14;15;16;14;015;0016;114;214;314;414;N;12/15;15;14;None;3.6466;130;19;14;15;126;14;014;137;07261;หนองดินแดง;0821;เมืองนครปฐม;72;นครปฐม;73014;14;19;14;15;15;16;27;26;07261;หนองดินแดง;0821;เมืองนครปฐม;72;นครปฐม;73014;Comp;25;19;14;15;14;014;15;34;0821;หนองดินแดง;0801;เมืองนครปฐม;72;นครปฐม;73014;014;N;15;N;Y;Y;จันทร์จิรา;ตั้งต้น;16;แม่;0933018882;0985674550;นนทบุรี;14;014;0014;xxx;Y;F;AA;14;Y;N;12/15;Y;สมปอง;M;0014;14;Comp;26;T;R;114;15;14;P;Y;024;126;14;14;114;137;10014;10013;120213;S;10013;Y;AA;23156;RR;TT;63;RF;0001;YY;1006;BE;14;15;114;1014;124;Y;21335;48;0113;0102;Dan;ชลบุรี;016;A;AA;AAA;1217;RE;125;014;MISTER;QE;100013;AA;LD;0014;100014;-;0113;2014;5014;6014;Y;113;1014;F;AA;AB;AC;1125;-;-;09335;3233;1136;47;A;O;TR;0335;14;154;AG;10014;21;14;014;F;024;0207;014;036;10013;T;10013;0014;0936;14;1125;Y;14;RE;0000;14;10013;113;A;0226;0025;14;014;113;Dan;013;TU;SC;SSC;NG;0123;014;10013;90013;xxxx;13;14;13;14;0334;0656;-;1116;0013;C;T;C;0112;F;F;000;N;Y;RG;N;Y;Y;N;Y;N;N;Y;Y;Y;N;Y;xxxx;0014;01023;469;Dan;xxx;-;AA;1005;1247;0013;13;CF;xxx;-;AA;Y;N;Y;Y;Y;RE;14;10013;0013;23;Y;Y;N;Y;23;13;113;150;P;xxxx;10013;-;xxxx;0136;-;-;0013;14;เอก;913;-;xxxx;xxxx;xxxx;xxxx;xxxx;xxxx;xxxx;xxxx;xxxx;xxxx;xxxx;xxxx;xxxx;xxxx;;;;;;;;;
426393326;0124058860;MTR;16;0004;1012;LCG;999;1;4;5;12;6;16;791;0821;A;5768;หนองดินแดง;00113;นครปฐม;0014;124154250;xxxx;xx;1.7399E+12;นาง;015;ศศิธร;จำปา;นางศศิธร จำปา;0630600105;-;TH;P;20;2005-05-10T00:00:14;33;18;19;14;15;034286306;034286306;25;ส่งสินค้า;024;138;16;2024-09-29T10:56:18.027;10128;2024-10-03T13:32:02.441;15;0014;17;A;RE;0926;Aek;Sri;Aek Sri;-;046;F;014;xxx;03225;2048;46;0014;14;SC;SC15;SSC;xxxx;-;0014;xxxx;17;14;15;14;15;23;0504600139256;16;016;สำนักงานใหญ่;16;17;20;Car;New Car;15;Y;New Car;2471040039;15;18;86;1206;711941;PCX 121;17;15;15;15;112100.0015;94600.0015;6188.7915;88411.2115;21;57;1.1015;13.5615;13.2015;3292.0014;215.3615;3076.6415;138264.0015;9045.3115;129218.6915;7.0015;22.8490;19;12592;3206;อาจณรงค์ แก้วกรูด;อาจณรงค์;16;-;Sales Exec;-;43;042;ศูนย์อำนวยสินเชื่อนครปฐม;292;1124;1124 NAKHONPATHOM;9986;28;26;WEST;417;บจก. เกรียงไกร มอเตอร์เซลส์;KRIANGKRAIMOTORSALE CO., LTD.;Active;-;254;7007416;สนญ. เมืองสุพรรณบุรี;HO. MUANGSUPHANBURI;15;16;0124154251;2024-09-29T10:53:01.242;2023-12-07T00:00:15;17;1;2;3;4;5;2024-09-29T10:53:01.425;2024-09-29T10:56:55.205;2024-09-29T11:10:23.285;15;15;18;15;29;15;32;15;15;15;15;15;10007;chanidapha.k;ชณิดาภา แคล้วเครือ;15;15;15;2023-12-03T14:10:44.398;15;15;15;15;15;16;pada.l;16;016;สำนักงานใหญ่;17500.0015;15;467;yingyos.h;15;15;Normal;18;816;0.15;0.15;87312.0015;20;17;Electric Starter;16;Disc-Disc;17;Mag wheel;16;Automatic;175;2024-01-05T00:00:15;15;15;15;19;Central Area 1,17;15;Salary;27.4315;15;A;16;18;12000.0015;M;A;1.1015;15;026;A;Y;72015;15;17;2031-05-09T00:00:15;94;126;24;016;027;114;115;16;016;16;15;16;A;S;126;237;348;T;ABC;O;16;P;015;16;126;A;115;15;15;AAA;25;B;Y;15;16;13;18;19;20;C;Y;16;15;16;2024-10-02T11:53:59.438;15;0;0;0;0;A;0;16;1600;93910.0012;Registered company - Permanent Staff;15;N;15;160;15;15;B;2.1012;1739902182427;2023-12-07T00:00:15;0;0;0.0000;0.0000;0.0000;0.0010;A;COS040 GenerateContract;2024-10-03T13:32:02.442;A;15;016;Dan5;Wen;15;015;115;A;160;016;AAA;FT;A;15;115;215;FF;M;พนัส;136;12-16;Company;138;15;OT;18;16;15;16;TR;07247;0822;55;73015;1249;015;16;T;15;160;Z;B;15;1600;015;TR;MR;1600;AA;215;N;N;Y;M;3437;0099;12/16;15;0016;xxx;015;NN;1014;0015;16;1016;Y;015;025;45;0504600139256;016;45;0016;10015;15;16;17;15;016;0017;115;215;315;415;N;12/16;16;15;None;3.6467;131;20;15;16;127;15;015;138;07262;หนองดินแดง;0822;เมืองนครปฐม;73;นครปฐม;73015;15;20;15;16;16;17;28;27;07262;หนองดินแดง;0822;เมืองนครปฐม;73;นครปฐม;73015;Comp;26;20;15;16;15;015;16;35;0822;หนองดินแดง;0802;เมืองนครปฐม;73;นครปฐม;73015;015;N;16;N;Y;Y;จันทร์จิรา;ตั้งต้น;17;พ่อ;0933018883;0985674551;นนทบุรี;15;015;0015;xxx;T;P;AA;15;N;Y;12/16;Y;สมใจ;M;0015;15;Comp;27;T;R;115;16;15;P;Y;025;127;15;15;115;138;10015;10014;120213;S;10014;Y;AA;23157;RR;TT;64;RF;0002;YY;1007;BE;15;16;115;1015;125;Y;21336;49;0114;0103;Dan;ชลบุรี;017;A;AA;AAA;1218;RE;126;015;MISTER;RC;100014;BB;EM;0015;100015;-;0114;2015;5015;6015;N;114;1015;F;AA;AB;AC;1126;-;-;09336;3234;1137;48;A;O;QR;0336;15;165;AG;10015;22;15;015;F;025;0208;015;037;10014;Y;10014;0015;0937;15;1126;Y;15;FE;0000;15;10014;114;A;0227;0026;15;015;114;Dan;014;TU;SC;SSC;NG;0124;015;10014;90014;xxxx;14;15;14;15;0335;0657;-;1117;0014;T;C;C;0113;P;P;000;Y;N;RG;Y;Y;Y;N;Y;N;N;Y;Y;Y;N;Y;xxxx;0015;01024;470;Dan;xxx;-;AA;1006;1248;0014;14;CF;xxx;-;AA;Y;N;Y;Y;Y;RE;15;10014;0014;24;Y;Y;N;Y;24;14;114;160;P;xxxx;10014;-;xxxx;0137;-;-;0014;15;เอก;914;-;xxxx;xxxx;xxxx;xxxx;xxxx;xxxx;xxxx;xxxx;xxxx;xxxx;xxxx;xxxx;xxxx;xxxx;;;;;;;;;
20290927150003;0123065712;MTR;17;0000;1010;AAM;1000;2;5;1;12;2;17;792;0822;A;5769;หนองดินแดง;00114;นครปฐม;0015;124154251;xxxx;xx;1.7399E+12;นาย;016;เอกพล;ศรีพรหม;นาย เอกพล ศรีพรหม;0630600106;-;TH;P;21;2005-05-10T00:00:15;34;19;19;15;16;034286307;034286307;26;ส่งสินค้า;025;139;17;2024-09-29T10:56:18.028;10129;2024-10-03T13:32:02.442;16;0015;18;A;FE;0927;Aek;Sri;Aek Sri;-;047;M;015;xxx;03226;2049;47;0015;15;SC;SC16;SSC;xxxx;-;0015;xxxx;18;15;16;15;16;24;0504600139257;17;017;สำนักงานใหญ่;17;18;21;Motorcycle;New Car;16;Y;New Car;2471040040;16;19;87;1207;711942;PCX 122;18;16;16;16;112100.0016;94600.0016;6188.7916;88411.2116;22;58;1.1016;13.5616;13.2016;3292.0015;215.3616;3076.6416;138264.0016;9045.3116;129218.6916;7.0016;22.8491;20;12593;3207;อาจณรงค์ แก้วกรูด;อาจณรงค์;17;-;Sales Exec;-;44;043;ศูนย์อำนวยสินเชื่อนครปฐม;293;1125;1125 NAKHONPATHOM;9987;29;27;WEST;418;บจก. เกรียงไกร มอเตอร์เซลส์;KRIANGKRAIMOTORSALE CO., LTD.;Active;-;255;7007417;สนญ. เมืองสุพรรณบุรี;HO. MUANGSUPHANBURI;16;17;0124154252;2024-09-29T10:53:01.243;2023-12-07T00:00:16;18;1;2;3;4;5;2024-09-29T10:53:01.426;2024-09-29T10:56:55.206;2024-09-29T11:10:23.286;16;16;19;16;30;16;33;16;16;16;16;16;10008;chanidapha.k;ชณิดาภา แคล้วเครือ;16;16;16;2023-12-03T14:10:44.399;16;16;16;16;16;17;pada.l;17;017;สำนักงานใหญ่;17500.0016;16;468;yingyos.h;16;16;Normal;19;817;0.16;0.16;87312.0016;21;18;Electric Starter;17;Disc-Disc;18;Mag wheel;17;Automatic;176;2024-01-05T00:00:16;16;16;16;20;Central Area 1,18;16;Salary;27.4316;16;A;17;19;12000.0016;M;A;1.1016;16;027;A;Y;72016;16;18;2031-05-09T00:00:16;95;127;25;017;028;115;116;17;017;17;16;17;A;S;127;238;349;T;ABC;O;17;P;016;17;127;A;116;16;16;AAA;26;A;Y;16;17;14;19;20;21;C;Y;17;16;17;2024-10-02T11:53:59.439;16;0;0;0;0;A;0;17;1700;93910.0013;Registered company - Permanent Staff;16;M;16;170;16;16;A;2.1013;1739902182428;2023-12-07T00:00:16;0;0;0.0000;0.0000;0.0000;0.0011;A;COS040 GenerateContract;2024-10-03T13:32:02.443;A;16;017;Dan;Wen;16;016;116;B;170;017;BBB;MT;A;16;116;216;TT;F;พนัส;137;12-17;Company;139;16;OT;19;17;16;17;TR;07247;0823;55;73016;1250;016;17;S;16;170;A;B;16;1700;016;TR;MR;1700;BB;216;N;Y;N;T;3438;0099;12/17;16;0017;xxx;016;YY;1015;0016;17;1017;N;016;026;46;0504600139257;017;46;0017;10016;16;17;18;16;017;0018;116;216;316;416;N;12/17;17;16;None;3.6468;132;21;16;17;128;16;016;139;07263;หนองดินแดง;0823;เมืองนครปฐม;74;นครปฐม;73016;16;21;16;17;17;18;29;28;07263;หนองดินแดง;0823;เมืองนครปฐม;74;นครปฐม;73016;Comp;27;21;16;17;16;016;17;36;0823;หนองดินแดง;0803;เมืองนครปฐม;74;นครปฐม;73016;016;N;17;N;Y;Y;จันทร์จิรา;ตั้งต้น;18;แม่;0933018884;0985674552;นนทบุรี;16;016;0016;xxx;Y;P;AA;16;Y;N;12/17;Y;สมชาย;M;0016;16;Comp;28;T;R;116;17;16;P;Y;026;128;16;16;116;139;10016;10015;120213;S;10015;Y;AA;23158;RR;TT;65;RF;0003;YY;1008;BE;16;17;116;1016;126;Y;21337;50;0115;0104;Dan;ชลบุรี;018;A;AA;AAA;1219;RE;127;016;MISS;QE;100015;AA;LD;0016;100016;-;0115;2016;5016;6016;Y;115;1016;F;AA;AB;AC;1127;-;-;09337;3235;1138;49;A;O;TR;0337;16;176;AG;10016;23;16;016;F;026;0209;016;038;10015;T;10015;0016;0938;16;1127;Y;16;RE;0000;16;10015;115;A;0228;0027;16;016;115;Dan;015;TU;SC;SSC;NG;0125;016;10015;90015;xxxx;15;16;15;16;0336;0658;-;1118;0015;C;T;C;0114;F;F;000;N;Y;RG;N;Y;Y;N;Y;N;N;Y;Y;Y;N;Y;xxxx;0016;01025;471;Dan;xxx;-;AA;1007;1249;0015;15;CF;xxx;-;AA;Y;N;Y;Y;Y;RE;16;10015;0015;25;Y;Y;N;Y;25;15;115;170;P;xxxx;10015;-;xxxx;0138;-;-;0015;16;เอก;915;-;xxxx;xxxx;xxxx;xxxx;xxxx;xxxx;xxxx;xxxx;xxxx;xxxx;xxxx;xxxx;xxxx;xxxx;;;;;;;;;
20241024_131740;0124058860;MTR;18;0001;1011;LCG;999;1;2;2;12;3;18;793;0823;A;5770;หนองดินแดง;00115;นครปฐม;0016;124154252;xxxx;xx;1.7399E+12;นางสาว;017;นงนภัส;แก้วไก่;นางสาว นงนภัส แก้วไก่;0630600107;-;TH;P;22;2005-05-10T00:00:16;35;20;19;16;17;034286308;034286308;27;ส่งสินค้า;026;140;18;2024-09-29T10:56:18.029;10130;2024-10-03T13:32:02.443;17;0016;19;A;RE;0928;Aek;Sri;Aek Sri;-;048;F;016;xxx;03227;2050;48;0016;16;SC;SC17;SSC;xxxx;-;0016;xxxx;19;16;17;16;17;25;0504600139258;18;018;สำนักงานใหญ่;18;19;22;Motorcycle;New Car;17;Y;New Car;2471040041;17;20;88;1208;711943;PCX 123;19;17;17;17;112100.0017;94600.0017;6188.7917;88411.2117;23;59;1.1017;13.5617;13.2017;3292.0016;215.3617;3076.6417;138264.0017;9045.3117;129218.6917;7.0017;22.8492;21;12594;3208;อาจณรงค์ แก้วกรูด;อาจณรงค์;18;-;Sales Exec;-;45;044;ศูนย์อำนวยสินเชื่อนครปฐม;294;1126;1126 NAKHONPATHOM;9988;30;28;WEST;419;บจก. เกรียงไกร มอเตอร์เซลส์;KRIANGKRAIMOTORSALE CO., LTD.;Active;-;256;7007418;สนญ. เมืองสุพรรณบุรี;HO. MUANGSUPHANBURI;17;18;0124154253;2024-09-29T10:53:01.244;2023-12-07T00:00:17;19;1;2;3;4;5;2024-09-29T10:53:01.427;2024-09-29T10:56:55.207;2024-09-29T11:10:23.287;17;17;20;17;31;17;34;17;17;17;17;17;10009;chanidapha.k;ชณิดาภา แคล้วเครือ;17;17;17;2023-12-03T14:10:44.400;17;17;17;17;17;18;pada.l;18;018;สำนักงานใหญ่;17500.0017;17;469;yingyos.h;17;17;Normal;20;818;0.17;0.17;87312.0017;22;19;Electric Starter;18;Disc-Disc;19;Mag wheel;18;Automatic;177;2024-01-05T00:00:17;17;17;17;21;Central Area 1,19;17;Salary;27.4317;17;A;18;20;12000.0017;M;A;1.1017;17;028;A;Y;72017;17;19;2031-05-09T00:00:17;96;128;26;018;029;116;117;18;018;18;17;18;A;S;128;239;350;T;ABC;O;18;P;017;18;128;A;117;17;17;AAA;27;B;Y;17;18;15;20;21;22;C;Y;18;17;18;2024-10-02T11:53:59.440;17;0;0;0;0;A;0;18;1800;93910.0014;Registered company - Permanent Staff;17;T;17;180;17;17;B;2.1014;1739902182429;2023-12-07T00:00:17;0;0;0.0000;0.0000;0.0000;0.0012;A;COS040 GenerateContract;2024-10-03T13:32:02.444;A;17;018;Dan6;Wen;17;017;117;C;180;018;CCC;FT;A;17;117;217;FF;M;พนัส;138;12-18;Company;140;17;OT;20;18;17;18;TR;07247;0824;55;73017;1251;017;18;T;17;180;Z;B;17;1800;017;TR;MR;1800;CC;217;N;N;N;M;3439;0099;12/18;17;0018;xxx;017;NN;1016;0017;18;1018;Y;017;027;47;0504600139258;018;47;0018;10017;17;18;19;17;018;0019;117;217;317;417;N;12/18;18;17;None;3.6469;133;22;17;18;129;17;017;140;07264;หนองดินแดง;0824;เมืองนครปฐม;75;นครปฐม;73017;17;22;17;18;18;19;30;29;07264;หนองดินแดง;0824;เมืองนครปฐม;75;นครปฐม;73017;Comp;28;22;17;18;17;017;18;37;0824;หนองดินแดง;0804;เมืองนครปฐม;75;นครปฐม;73017;017;N;18;N;Y;Y;จันทร์จิรา;ตั้งต้น;19;พ่อ;0933018885;0985674553;นนทบุรี;17;017;0017;xxx;T;F;AA;17;N;Y;12/18;Y;สมปอง;M;0017;17;Comp;29;T;R;117;18;17;P;Y;027;129;17;17;117;140;10017;10016;120213;S;10016;Y;AA;23159;RR;TT;66;RF;0000;YY;1009;BE;17;18;117;1017;127;Y;21338;51;0116;0105;Dan;ชลบุรี;019;A;AA;AAA;1220;RE;128;017;MISTER;RC;100016;BB;EM;0017;100017;-;0116;2017;5017;6017;N;116;1017;F;AA;AB;AC;1128;-;-;09338;3236;1139;50;A;O;QR;0338;17;187;AG;10017;24;17;017;F;027;0210;017;039;10016;Y;10016;0017;0939;17;1128;Y;17;FE;0000;17;10016;116;A;0229;0028;17;017;116;Dan;016;TU;SC;SSC;NG;0126;017;10016;90016;xxxx;16;17;16;17;0337;0659;-;1119;0016;T;C;C;0115;P;P;000;Y;N;RG;Y;Y;Y;N;Y;N;N;Y;Y;Y;N;Y;xxxx;0017;01026;472;Dan;xxx;-;AA;1008;1250;0016;16;CF;xxx;-;AA;Y;N;Y;Y;Y;RE;17;10016;0016;26;Y;Y;N;Y;26;16;116;180;P;xxxx;10016;-;xxxx;0139;-;-;0016;17;เอก;916;-;xxxx;xxxx;xxxx;xxxx;xxxx;xxxx;xxxx;xxxx;xxxx;xxxx;xxxx;xxxx;xxxx;xxxx;;;;;;;;;
716714577;0123065712;MTR;19;0002;1012;AAM;1000;2;3;3;12;4;19;794;0824;A;5771;หนองดินแดง;00116;นครปฐม;0017;124154253;xxxx;xx;1.7399E+12;นาง;018;ศศิธร;จำปา;นางศศิธร จำปา;0630600108;-;TH;P;23;2005-05-10T00:00:17;36;21;19;17;18;034286309;034286309;28;ส่งสินค้า;027;141;19;2024-09-29T10:56:18.030;10131;2024-10-03T13:32:02.444;18;0017;20;A;FE;0929;Aek;Sri;Aek Sri;-;049;F;017;xxx;03228;2051;49;0017;17;SC;SC18;SSC;xxxx;-;0017;xxxx;20;17;18;17;18;26;0504600139259;19;019;สำนักงานใหญ่;19;20;23;Motorcycle;New Car;18;Y;New Car;2471040042;18;21;89;1209;711944;PCX 124;20;18;18;18;112100.0018;94600.0018;6188.7918;88411.2118;24;60;1.1018;13.5618;13.2018;3292.0017;215.3618;3076.6418;138264.0018;9045.3118;129218.6918;7.0018;22.8493;22;12595;3209;อาจณรงค์ แก้วกรูด;อาจณรงค์;19;-;Sales Exec;-;46;045;ศูนย์อำนวยสินเชื่อนครปฐม;295;1127;1127 NAKHONPATHOM;9989;31;29;WEST;420;บจก. เกรียงไกร มอเตอร์เซลส์;KRIANGKRAIMOTORSALE CO., LTD.;Active;-;257;7007419;สนญ. เมืองสุพรรณบุรี;HO. MUANGSUPHANBURI;18;19;0124154254;2024-09-29T10:53:01.245;2023-12-07T00:00:18;20;1;2;3;4;5;2024-09-29T10:53:01.428;2024-09-29T10:56:55.208;2024-09-29T11:10:23.288;18;18;21;18;32;18;35;18;18;18;18;18;10010;chanidapha.k;ชณิดาภา แคล้วเครือ;18;18;18;2023-12-03T14:10:44.401;18;18;18;18;18;19;pada.l;19;019;สำนักงานใหญ่;17500.0018;18;470;yingyos.h;18;18;Normal;21;819;0.18;0.18;87312.0018;23;20;Electric Starter;19;Disc-Disc;20;Mag wheel;19;Automatic;178;2024-01-05T00:00:18;18;18;18;22;Central Area 1,20;18;Salary;27.4318;18;A;19;21;12000.0018;M;A;1.1018;18;029;A;Y;72018;18;20;2031-05-09T00:00:18;97;129;27;019;030;117;118;19;019;19;18;19;A;S;129;240;351;T;ABC;O;19;P;018;19;129;A;118;18;18;AAA;28;A;Y;18;19;16;21;22;23;C;Y;19;18;19;2024-10-02T11:53:59.441;18;0;0;0;0;A;0;19;1900;93910.0015;Registered company - Permanent Staff;18;N;18;190;18;18;A;2.1015;1739902182430;2023-12-07T00:00:18;0;0;0.0000;0.0000;0.0000;0.0013;A;COS040 GenerateContract;2024-10-03T13:32:02.445;A;18;019;Dan;Wen;18;018;118;A;190;019;AAA;MT;A;18;118;218;TT;F;พนัส;139;12-19;Company;141;18;OT;21;19;18;19;TR;07247;0825;55;73018;1252;018;19;S;18;190;A;B;18;1900;018;TR;MR;1900;CC;218;Y;N;Y;T;3440;0099;12/19;18;0019;xxx;018;YY;1017;0018;19;1019;N;018;028;48;0504600139259;019;48;0019;10018;18;19;20;18;019;0020;118;218;318;418;N;12/19;19;18;None;3.6470;134;23;18;19;130;18;018;141;07265;หนองดินแดง;0825;เมืองนครปฐม;76;นครปฐม;73018;18;23;18;19;19;20;31;30;07265;หนองดินแดง;0825;เมืองนครปฐม;76;นครปฐม;73018;Comp;29;23;18;19;18;018;19;38;0825;หนองดินแดง;0805;เมืองนครปฐม;76;นครปฐม;73018;018;N;19;N;Y;Y;จันทร์จิรา;ตั้งต้น;20;แม่;0933018886;0985674554;นนทบุรี;18;018;0018;xxx;Y;F;AA;18;Y;N;12/19;Y;สมใจ;M;0018;18;Comp;30;T;R;118;19;18;P;Y;028;130;18;18;118;141;10018;10017;120213;S;10017;Y;AA;23160;RR;TT;67;RF;0001;YY;1010;BE;18;19;118;1018;128;Y;21339;52;0117;0106;Dan;ชลบุรี;020;A;AA;AAA;1221;RE;129;018;MISTER;QE;100017;AA;LD;0018;100018;-;0117;2018;5018;6018;Y;117;1018;F;AA;AB;AC;1129;-;-;09339;3237;1140;51;A;O;TR;0339;18;198;AG;10018;25;18;018;F;028;0211;018;040;10017;T;10017;0018;0940;18;1129;Y;18;RE;0000;18;10017;117;A;0230;0029;18;018;117;Dan;017;TU;SC;SSC;NG;0127;018;10017;90017;xxxx;17;18;17;18;0338;0660;-;1120;0017;C;T;C;0116;F;F;000;N;Y;RG;N;Y;Y;N;Y;N;N;Y;Y;Y;N;Y;xxxx;0018;01027;473;Dan;xxx;-;AA;1009;1251;0017;17;CF;xxx;-;AA;Y;N;Y;Y;Y;RE;18;10017;0017;27;Y;Y;N;Y;27;17;117;190;P;xxxx;10017;-;xxxx;0140;-;-;0017;18;เอก;917;-;xxxx;xxxx;xxxx;xxxx;xxxx;xxxx;xxxx;xxxx;xxxx;xxxx;xxxx;xxxx;xxxx;xxxx;;;;;;;;;
906383135;0124058860;MTR;20;0003;1010;LCG;999;1;4;4;12;5;20;795;0825;A;5772;หนองดินแดง;00117;นครปฐม;0018;124154254;xxxx;xx;1.7399E+12;นาย;019;เอกพล;ศรีพรหม;นาย เอกพล ศรีพรหม;0630600109;-;TH;P;24;2005-05-10T00:00:18;37;22;19;18;19;034286310;034286310;29;ส่งสินค้า;028;142;20;2024-09-29T10:56:18.031;10132;2024-10-03T13:32:02.445;19;0018;21;A;RE;0930;Aek;Sri;Aek Sri;-;050;M;018;xxx;03229;2052;50;0018;18;SC;SC19;SSC;xxxx;-;0018;xxxx;21;18;19;18;19;27;0504600139260;20;020;สำนักงานใหญ่;20;21;24;Car;New Car;19;Y;New Car;2471040043;19;22;90;1210;711945;PCX 125;21;19;19;19;112100.0019;94600.0019;6188.7919;88411.2119;25;61;1.1019;13.5619;13.2019;3292.0018;215.3619;3076.6419;138264.0019;9045.3119;129218.6919;7.0019;22.8494;23;12596;3210;อาจณรงค์ แก้วกรูด;อาจณรงค์;20;-;Sales Exec;-;47;046;ศูนย์อำนวยสินเชื่อนครปฐม;296;1128;1128 NAKHONPATHOM;9990;32;30;WEST;421;บจก. เกรียงไกร มอเตอร์เซลส์;KRIANGKRAIMOTORSALE CO., LTD.;Active;-;258;7007420;สนญ. เมืองสุพรรณบุรี;HO. MUANGSUPHANBURI;19;20;0124154255;2024-09-29T10:53:01.246;2023-12-07T00:00:19;21;1;2;3;4;5;2024-09-29T10:53:01.429;2024-09-29T10:56:55.209;2024-09-29T11:10:23.289;19;19;22;19;33;19;36;19;19;19;19;19;10011;chanidapha.k;ชณิดาภา แคล้วเครือ;19;19;19;2023-12-03T14:10:44.402;19;19;19;19;19;20;pada.l;20;020;สำนักงานใหญ่;17500.0019;19;471;yingyos.h;19;19;Normal;22;820;0.19;0.19;87312.0019;24;21;Electric Starter;20;Disc-Disc;21;Mag wheel;20;Automatic;179;2024-01-05T00:00:19;19;19;19;23;Central Area 1,21;19;Salary;27.4319;19;A;20;22;12000.0019;M;A;1.1019;19;030;A;Y;72019;19;21;2031-05-09T00:00:19;98;130;28;020;031;118;119;20;020;20;19;20;A;S;130;241;352;T;ABC;O;20;P;019;20;130;A;119;19;19;AAA;29;B;Y;19;20;17;22;23;24;C;Y;20;19;20;2024-10-02T11:53:59.442;19;0;0;0;0;A;0;20;2000;93910.0016;Registered company - Permanent Staff;19;M;19;200;19;19;B;2.1016;1739902182431;2023-12-07T00:00:19;0;0;0.0000;0.0000;0.0000;0.0014;A;COS040 GenerateContract;2024-10-03T13:32:02.446;A;19;020;Dan6;Wen;19;019;119;B;200;020;BBB;FT;A;19;119;219;FF;M;พนัส;140;12-20;Company;142;19;OT;22;20;19;20;TR;07247;0826;55;73019;1253;019;20;T;19;200;Z;B;19;2000;019;TR;MR;2000;AA;219;Y;Y;Y;M;3441;0099;12/20;19;0020;xxx;019;NN;1018;0019;20;1020;Y;019;029;49;0504600139260;020;49;0020;10019;19;20;21;19;020;0021;119;219;319;419;N;12/20;20;19;None;3.6471;135;24;19;20;131;19;019;142;07266;หนองดินแดง;0826;เมืองนครปฐม;77;นครปฐม;73019;19;24;19;20;20;21;32;31;07266;หนองดินแดง;0826;เมืองนครปฐม;77;นครปฐม;73019;Comp;30;24;19;20;19;019;20;39;0826;หนองดินแดง;0806;เมืองนครปฐม;77;นครปฐม;73019;019;N;20;N;Y;Y;จันทร์จิรา;ตั้งต้น;21;พ่อ;0933018887;0985674555;นนทบุรี;19;019;0019;xxx;T;P;AA;19;N;N;12/20;Y;สมชาย;M;0019;19;Comp;31;T;R;119;20;19;P;Y;029;131;19;19;119;142;10019;10018;120213;S;10018;Y;AA;23161;RR;TT;68;RF;0002;YY;1011;BE;19;20;119;1019;129;Y;21340;53;0118;0107;Dan;ชลบุรี;021;A;AA;AAA;1222;RE;130;019;MISTER;RC;100018;BB;EM;0019;100019;-;0118;2019;5019;6019;N;118;1019;F;AA;AB;AC;1130;-;-;09340;3238;1141;52;A;O;QR;0340;19;209;AG;10019;26;19;019;F;029;0212;019;041;10018;Y;10018;0019;0941;19;1130;Y;19;FE;0000;19;10018;118;A;0231;0030;19;019;118;Dan;018;TU;SC;SSC;NG;0128;019;10018;90018;xxxx;18;19;18;19;0339;0661;-;1121;0018;T;C;C;0117;P;P;000;Y;N;RG;Y;Y;Y;N;Y;N;N;Y;Y;Y;N;Y;xxxx;0019;01028;474;Dan;xxx;-;AA;1010;1252;0018;18;CF;xxx;-;AA;Y;N;Y;Y;Y;RE;19;10018;0018;28;Y;Y;N;Y;28;18;118;200;P;xxxx;10018;-;xxxx;0141;-;-;0018;19;เอก;918;-;xxxx;xxxx;xxxx;xxxx;xxxx;xxxx;xxxx;xxxx;xxxx;xxxx;xxxx;xxxx;xxxx;xxxx;;;;;;;;;
426393326;0124058860;MTR;21;0004;1011;AAM;1000;2;5;5;12;6;21;796;0826;A;5773;หนองดินแดง;00118;นครปฐม;0019;124154255;xxxx;xx;1.7399E+12;นางสาว;020;นงนภัส;แก้วไก่;นางสาว นงนภัส แก้วไก่;0630600110;-;TH;P;25;2005-05-10T00:00:19;38;23;19;19;20;034286311;034286311;30;ส่งสินค้า;029;143;21;2024-09-29T10:56:18.032;10133;2024-10-03T13:32:02.446;20;0019;22;A;FE;0931;Aek;Sri;Aek Sri;-;051;F;019;xxx;03230;2053;51;0019;19;SC;SC20;SSC;xxxx;-;0019;xxxx;22;19;20;19;20;28;0504600139261;21;021;สำนักงานใหญ่;21;22;25;Car;New Car;20;Y;New Car;2471040044;20;23;91;1211;711946;PCX 126;22;20;20;20;112100.0020;94600.0020;6188.7920;88411.2120;26;62;1.1020;13.5620;13.2020;3292.0019;215.3620;3076.6420;138264.0020;9045.3120;129218.6920;7.0020;22.8495;24;12597;3211;อาจณรงค์ แก้วกรูด;อาจณรงค์;21;-;Sales Exec;-;48;047;ศูนย์อำนวยสินเชื่อนครปฐม;297;1129;1129 NAKHONPATHOM;9991;33;31;WEST;422;บจก. เกรียงไกร มอเตอร์เซลส์;KRIANGKRAIMOTORSALE CO., LTD.;Active;-;259;7007421;สนญ. เมืองสุพรรณบุรี;HO. MUANGSUPHANBURI;20;21;0124154256;2024-09-29T10:53:01.247;2023-12-07T00:00:20;22;1;2;3;4;5;2024-09-29T10:53:01.430;2024-09-29T10:56:55.210;2024-09-29T11:10:23.290;20;20;23;20;34;20;37;20;20;20;20;20;10012;chanidapha.k;ชณิดาภา แคล้วเครือ;20;20;20;2023-12-03T14:10:44.403;20;20;20;20;20;21;pada.l;21;021;สำนักงานใหญ่;17500.0020;20;472;yingyos.h;20;20;Normal;23;821;0.20;0.20;87312.0020;25;22;Electric Starter;21;Disc-Disc;22;Mag wheel;21;Automatic;180;2024-01-05T00:00:20;20;20;20;24;Central Area 1,22;20;Salary;27.4320;20;A;21;23;12000.0020;M;A;1.1020;20;031;A;Y;72020;20;22;2031-05-09T00:00:20;99;131;29;021;032;119;120;21;021;21;20;21;A;S;131;242;353;T;ABC;O;21;P;020;21;131;A;120;20;20;AAA;30;B;Y;20;21;18;23;24;25;C;Y;21;20;21;2024-10-02T11:53:59.443;20;0;0;0;0;A;0;21;2100;93910.0017;Registered company - Permanent Staff;20;T;20;210;20;20;A;2.1017;1739902182432;2023-12-07T00:00:20;0;0;0.0000;0.0000;0.0000;0.0015;A;COS040 GenerateContract;2024-10-03T13:32:02.447;A;20;021;Dan;Wen;20;020;120;A;210;021;AAA;MT;A;20;120;220;TT;F;พนัส;141;12-21;Company;143;20;OT;23;21;20;21;TR;7247;0827;55;73020;1254;020;21;S;20;210;A;B;20;2100;020;TR;MR;2100;BB;220;Y;N;N;T;3442;0099;12/21;20;0021;xxx;020;YY;1019;0020;21;1021;N;020;030;50;0504600139261;021;50;0021;10020;20;21;22;20;021;0022;120;220;320;420;N;12/21;21;20;None;3.6472;136;25;20;21;132;20;020;143;07267;หนองดินแดง;0827;เมืองนครปฐม;78;นครปฐม;73020;20;25;20;21;21;22;33;32;07267;หนองดินแดง;0827;เมืองนครปฐม;78;นครปฐม;73020;Comp;31;25;20;21;20;020;21;40;0827;หนองดินแดง;0807;เมืองนครปฐม;78;นครปฐม;73020;020;N;21;N;Y;Y;จันทร์จิรา;ตั้งต้น;22;พ่อ;0933018888;0985674556;นนทบุรี;20;020;0020;xxx;T;P;AA;20;N;N;12/21;Y;สมชาย;M;0020;20;Comp;32;T;R;120;21;20;P;Y;030;132;20;20;120;143;10020;10019;120213;S;10019;Y;AA;23162;RR;TT;69;RF;0003;YY;1012;BE;20;21;120;1020;130;Y;21341;54;0119;0108;Dan;ชลบุรี;022;A;AA;AAA;1223;RE;131;020;MISTER;RC;100019;BB;EM;0020;100020;-;0119;2020;5020;6020;N;119;1020;F;AA;AB;AC;1131;-;-;09341;3239;1142;53;A;O;QR;0341;20;210;AG;10020;27;20;020;F;030;0213;020;042;10019;Y;10019;0020;0942;20;1131;Y;20;FE;0001;20;10019;119;A;0232;0031;20;020;119;Dan;019;TU;SC;SSC;NG;0129;020;10019;90019;xxxx;19;20;19;20;0340;0662;-;1122;0019;C;T;C;0118;F;F;000;N;Y;RG;N;Y;Y;N;Y;N;N;Y;Y;Y;N;Y;xxxx;0020;01029;475;Dan;xxx;-;AA;1011;1253;0019;19;CF;xxx;-;AA;Y;N;Y;Y;Y;RE;20;10019;0019;29;Y;Y;N;Y;29;19;119;210;P;xxxx;10019;-;xxxx;0142;-;-;0019;20;เอก;919;-;xxxx;xxxx;xxxx;xxxx;xxxx;xxxx;xxxx;xxxx;xxxx;xxxx;xxxx;xxxx;xxxx;xxxx;;;;;;;;;
;;;;;;;;;;;;;;;;;;;;;;;;;;;;;;;;;;;;;;;;;;;;;;;;;;;;;;;;;;;;;;;;;;;;;;;;;;;;;;;;;;;;;;;;;;;;;;;;;;;;;;;;;;;;;;;;;;;;;;;;;;;;;;;;;;;;;;;;;;;;;;;;;;;;;;;;;;;;;;;;;;;;;;;;;;;;;;;;;;;;;;;;;;;;;;;;;;;;;;;;;;;;;;;;;;;;;;;;;;;;;;;;;;;;;;;;;;;;;;;;;;;;;;;;;;;;;;;;;;;;;;;;;;;;;;;;;;;;;;;;;;;;;;;;;;;;;;;;;;;;;;;;;;;;;;;;;;;;;;;;;;;;;;;;;;;;;;;;;;;;;;;;;;;;;;;;;;;;;;;;;;;;;;;;;;;;;;;;;;;;;;;;;;;;;;;;;;;;;;;;;;;;;;;;;;;;;;;;;;;;;;;;;;;;;;;;;;;;;;;;;;;;;;;;;;;;;;;;;;;;;;;;;;;;;;;;;;;;;;;;;;;;;;;;;;;;;;;;;;;;;;;;;;;;;;;;;;;;;;;;;;;;;;;;;;;;;;;;;;;;;;;;;;;;;;;;;;;;;;;;;;;;;;;;;;;;;;;;;;;;;;;;;;;;;;;;;;;;;;;;;;;;;;;;;;;;;;;;;;;;;;;;;;;;;;;;;;;;;;;;;;;;;;;;;;;;;;;;;;;;;;;;;;;;;;;;;;;;;;;;;;;;;;;;;;;;;;;;;;;;;;;;;;;;
